Date,Team,Opponent,Home / Away,Result,Home Score,Visitor Score,Overtime,Goals,Assists,Points,Shots,Shots on Goal,Ground Balls,Turnovers,Caused Turnovers,Defensive Goals,Defensive Assists,Defensive Points,Defensive Shots,Defensive Shots on Goal,Defensive Groundball's,Defensive  Turnovers,Defensive  Caused Turnovers,g_min,Goals Allowed,Saves,defensive_g_min,Defensive Goals Allowed,Defensive Saves,na.x,na_2.x,na.y,na_2.y
2021-02-13,Air Force,Denver,Home,W,6,15,NA,6,4,10,35,17,20,17,7,15,12,27,58,32,37,18,10,60M 0S,15,17,60M 0S,6,11,NA,NA,NA,NA
2021-02-20,Air Force,Utah,Home,L,10,9,1,10,7,17,43,24,28,14,8,9,7,16,37,20,28,15,5,62M 25S,9,11,62M 25S,10,14,NA,NA,NA,NA
2021-02-27,Air Force,Duke,Away,L,7,17,NA,7,5,12,24,16,19,22,7,17,13,30,42,29,32,15,8,60M 0S,17,12,60M 0S,7,9,NA,NA,NA,NA
2021-03-06,Air Force,Virginia,Away,L,4,20,NA,4,3,7,28,15,31,26,7,20,17,37,43,27,56,29,17,60M 0S,20,7,60M 0S,4,11,NA,NA,NA,NA
2021-03-13,Air Force,Robert Morris,Home,L,13,14,NA,13,9,22,50,30,49,24,10,14,11,25,35,23,41,25,12,60M 0S,14,9,60M 0S,13,17,NA,NA,NA,NA
2021-03-20,Air Force,North Carolina,Away,L,5,15,NA,5,2,7,34,15,25,15,6,15,10,25,51,28,35,11,5,60M 0S,15,13,60M 0S,5,10,NA,NA,NA,NA
2021-03-27,Air Force,Bellarmine,Away,L,8,6,NA,8,7,15,34,17,22,18,7,6,4,10,30,22,17,11,9,60M 0S,6,16,60M 0S,8,9,NA,NA,NA,NA
2021-04-03,Air Force,Mercer,Home,L,13,15,NA,13,6,19,51,27,24,8,7,15,10,25,34,24,23,12,3,60M 0S,15,9,60M 0S,13,14,NA,NA,NA,NA
2021-04-10,Air Force,Jacksonville,Away,L,5,11,NA,5,1,6,44,21,28,13,8,11,4,15,41,22,34,22,8,60M 0S,11,11,60M 0S,5,16,NA,NA,NA,NA
2021-04-17,Air Force,VMI,Home,L,18,4,NA,18,10,28,52,31,39,13,13,4,3,7,22,11,19,24,5,60M 0S,4,7,60M 0S,18,13,NA,NA,NA,NA
2021-04-24,Air Force,High Point,Home,W,8,13,NA,8,5,13,45,20,27,11,11,13,8,21,45,25,31,16,6,60M 0S,13,12,60M 0S,8,12,NA,NA,NA,NA
2021-05-01,Air Force,Richmond,Away,L,9,8,NA,9,6,15,31,20,25,24,14,8,6,14,43,24,30,19,14,60M 0S,8,16,60M 0S,9,11,NA,NA,NA,NA
2021-05-05,Air Force,Richmond,Away,L,6,11,NA,6,4,10,40,18,26,18,6,11,6,17,38,24,31,13,13,60M 0S,11,13,60M 0S,6,12,NA,NA,NA,NA
2021-02-14,Army West Point,Virginia,Away,L,9,14,NA,9,3,12,38,22,27,16,6,14,7,21,46,25,47,14,13,60M 0S,14,11,60M 0S,9,13,NA,NA,NA,NA
2021-02-21,Army West Point,Syracuse,Away,L,18,11,NA,18,11,29,44,31,26,10,6,11,5,16,36,24,33,12,5,60M 0S,11,13,60M 0S,18,13,NA,NA,NA,NA
2021-02-27,Army West Point,Saint Joseph's,Home,L,13,5,NA,13,5,18,42,22,29,16,8,5,2,7,37,17,27,18,9,60M 0S,5,12,60M 0S,13,9,NA,NA,NA,NA
2021-03-06,Army West Point,Boston U.,Away,L,12,10,NA,12,5,17,45,24,42,18,10,10,6,16,43,27,31,14,12,60M 0S,10,17,60M 0S,12,12,NA,NA,NA,NA
2021-03-27,Army West Point,Holy Cross,Home,L,13,3,NA,13,12,25,45,29,36,11,9,3,2,5,27,14,20,17,6,60M 0S,3,11,60M 0S,13,16,NA,NA,NA,NA
2021-04-03,Army West Point,Lehigh,Away,W,12,13,NA,12,5,17,41,22,33,16,10,13,7,20,40,24,51,21,9,60M 0S,13,11,60M 0S,12,10,NA,NA,NA,NA
2021-04-10,Army West Point,Loyola Maryland,Away,W,12,7,NA,12,4,16,35,18,26,15,5,7,4,11,45,23,39,11,8,60M 0S,7,16,60M 0S,12,6,NA,NA,NA,NA
2021-04-17,Army West Point,Boston U.,Home,L,14,8,NA,14,11,25,55,31,41,14,8,8,4,12,31,18,33,19,6,60M 0S,8,10,60M 0S,14,17,NA,NA,NA,NA
2021-04-24,Army West Point,Navy,Away,W,4,9,NA,4,2,6,41,23,27,16,10,9,5,14,39,19,38,18,8,60M 0S,9,10,60M 0S,4,19,NA,NA,NA,NA
2021-04-30,Army West Point,Colgate,Home,W,13,11,NA,13,6,19,39,26,40,11,17,11,6,17,39,24,39,19,5,60M 0S,11,13,60M 0S,13,13,NA,NA,NA,NA
2021-05-07,Army West Point,"Loyola Maryland Bethlehem, Pa.",Away,W,10,11,NA,10,6,16,43,22,40,17,7,11,7,18,34,23,36,14,8,60M 0S,11,12,60M 0S,10,12,NA,NA,NA,NA
2021-01-30,Bellarmine,Mercer,Away,L,9,7,NA,9,3,12,29,15,20,22,17,7,4,11,31,17,40,31,14,60M 0S,7,10,60M 0S,9,6,NA,NA,NA,NA
2021-02-06,Bellarmine,Utah,Home,W,7,12,NA,7,6,13,31,16,21,12,10,12,7,19,31,22,27,16,6,60M 0S,12,10,60M 0S,7,9,NA,NA,NA,NA
2021-02-10,Bellarmine,Jacksonville,Away,L,8,19,NA,8,6,14,22,12,20,17,8,19,17,36,46,28,42,15,11,60M 0S,19,9,60M 0S,8,4,NA,NA,NA,NA
2021-02-28,Bellarmine,Delaware,Away,W,11,14,NA,11,2,13,27,20,31,21,13,14,8,22,42,23,44,23,10,60M 0S,14,9,60M 0S,11,9,NA,NA,NA,NA
2021-03-02,Bellarmine,Robert Morris,Away,L,8,17,NA,8,6,14,43,22,29,15,5,17,14,31,39,29,41,14,6,60M 0S,17,12,60M 0S,8,14,NA,NA,NA,NA
2021-03-06,Bellarmine,Notre Dame,Away,L,6,12,NA,6,3,9,20,14,13,18,7,12,9,21,41,27,37,17,8,60M 0S,12,15,60M 0S,6,8,NA,NA,NA,NA
2021-03-09,Bellarmine,VMI,Home,L,12,8,NA,12,6,18,36,27,37,21,11,8,4,12,31,21,27,22,11,60M 0S,8,13,60M 0S,12,15,NA,NA,NA,NA
2021-03-13,Bellarmine,Cleveland St.,Home,L,1,8,NA,1,1,2,39,18,22,14,6,8,7,15,30,24,16,13,6,60M 0S,8,16,60M 0S,1,17,NA,NA,NA,NA
2021-03-20,Bellarmine,Richmond,Home,W,5,17,NA,5,2,7,36,17,17,17,9,17,15,32,39,29,23,15,9,60M 0S,17,12,60M 0S,5,12,NA,NA,NA,NA
2021-03-27,Bellarmine,Air Force,Home,L,6,8,NA,6,4,10,30,22,17,11,9,8,7,15,34,17,22,18,7,60M 0S,8,9,60M 0S,6,16,NA,NA,NA,NA
2021-04-03,Bellarmine,High Point,Away,L,5,13,NA,5,5,10,33,17,20,11,6,13,12,25,33,17,36,21,5,60M 0S,13,4,60M 0S,5,12,NA,NA,NA,NA
2021-04-10,Bellarmine,VMI,Away,W,11,9,NA,11,7,18,36,20,27,18,11,9,6,15,32,23,26,16,11,60M 0S,9,14,60M 0S,11,9,NA,NA,NA,NA
2021-04-17,Bellarmine,Cleveland St.,Home,L,11,4,NA,11,8,19,27,16,26,23,17,4,4,8,16,7,23,27,12,60M 0S,4,3,60M 0S,11,5,NA,NA,NA,NA
2021-04-24,Bellarmine,Jacksonville,Away,W,7,8,NA,7,3,10,30,15,17,15,6,8,4,12,35,24,28,16,10,60M 0S,8,16,60M 0S,7,8,NA,NA,NA,NA
2021-05-01,Bellarmine,Mercer,Home,L,11,8,NA,11,7,18,31,21,10,13,7,8,7,15,35,21,29,24,7,60M 0S,8,13,60M 0S,11,10,NA,NA,NA,NA
2021-03-06,Binghamton,NJIT,Away,W,11,5,NA,11,7,18,32,24,38,22,12,5,3,8,30,10,30,28,9,60M 0S,5,5,60M 0S,11,13,NA,NA,NA,NA
2021-03-20,Binghamton,UAlbany,Home,W,7,19,NA,7,3,10,31,23,29,20,11,19,13,32,46,38,43,18,9,60M 0S,19,19,60M 0S,7,16,NA,NA,NA,NA
2021-03-24,Binghamton,UMBC,Home,W,8,7,1,8,5,13,25,13,25,20,9,7,5,12,48,25,31,18,8,63M 59S,7,18,63M 59S,8,5,NA,NA,NA,NA
2021-03-27,Binghamton,UMBC,Away,W,6,7,NA,6,2,8,21,14,26,19,5,7,5,12,45,24,28,14,4,60M 0S,7,17,60M 0S,6,8,NA,NA,NA,NA
2021-04-03,Binghamton,NJIT,Home,L,11,9,NA,11,5,16,37,26,35,19,12,9,7,16,26,22,26,19,12,60M 0S,9,13,60M 0S,11,15,NA,NA,NA,NA
2021-04-10,Binghamton,Hartford,Home,L,7,8,NA,7,5,12,29,21,35,25,11,8,2,10,38,24,35,20,14,60M 0S,8,16,60M 0S,7,14,NA,NA,NA,NA
2021-04-16,Binghamton,Stony Brook,Away,L,8,22,NA,8,4,12,27,19,34,19,6,22,15,37,46,33,46,15,6,60M 0S,22,11,60M 0S,8,11,NA,NA,NA,NA
2021-04-24,Binghamton,Vermont,Home,L,10,7,NA,10,4,14,38,21,28,15,12,7,2,9,41,22,30,16,5,60M 0S,7,15,60M 0S,10,11,NA,NA,NA,NA
2021-05-02,Binghamton,UMass Lowell,Away,W,11,9,NA,11,7,18,36,25,37,24,13,9,7,16,33,18,27,20,4,60M 0S,9,9,60M 0S,11,14,NA,NA,NA,NA
2021-02-20,Boston U.,Merrimack,Away,L,15,12,NA,15,8,23,35,16,30,21,7,12,6,18,56,29,40,13,8,60M 0S,12,17,60M 0S,15,1,NA,NA,NA,NA
2021-02-27,Boston U.,Pace,Home,L,15,2,NA,15,9,24,58,32,32,12,10,2,0,2,21,11,14,23,3,60M 0S,2,9,60M 0S,15,17,NA,NA,NA,NA
2021-03-06,Boston U.,Army West Point,Home,L,10,12,NA,10,6,16,43,27,31,14,12,12,5,17,45,24,42,18,10,60M 0S,12,12,60M 0S,10,17,NA,NA,NA,NA
2021-03-12,Boston U.,Holy Cross,Away,W,16,6,NA,16,13,29,42,27,24,16,11,6,3,9,34,22,29,25,8,60M 0S,6,16,60M 0S,16,11,NA,NA,NA,NA
2021-03-20,Boston U.,Colgate,Home,W,16,11,NA,16,7,23,50,31,34,13,9,11,4,15,28,22,31,21,5,60M 0S,11,11,60M 0S,16,15,NA,NA,NA,NA
2021-03-27,Boston U.,Lafayette,Away,W,13,9,NA,13,7,20,38,28,37,21,11,9,5,14,40,25,42,19,13,60M 0S,9,16,60M 0S,13,15,NA,NA,NA,NA
2021-04-03,Boston U.,Utah,Home,L,10,11,2,10,5,15,53,23,38,21,9,11,5,16,39,20,32,21,10,64M 28S,11,9,64M 28S,10,13,NA,NA,NA,NA
2021-04-10,Boston U.,Colgate,Away,L,14,10,NA,14,9,23,39,24,22,17,6,10,7,17,43,23,26,14,5,60M 0S,10,13,60M 0S,14,10,NA,NA,NA,NA
2021-04-17,Boston U.,Army West Point,Away,L,8,14,NA,8,4,12,31,18,33,19,6,14,11,25,55,31,41,14,8,60M 0S,14,17,60M 0S,8,10,NA,NA,NA,NA
2021-04-23,Boston U.,Brown,Home,W,5,12,NA,5,2,7,31,16,29,18,9,12,6,18,48,27,34,18,9,60M 0S,12,15,60M 0S,5,11,NA,NA,NA,NA
2021-05-04,Boston U.,Colgate,Home,W,8,11,NA,8,4,12,40,21,27,17,12,11,5,16,38,23,51,20,10,60M 0S,11,12,60M 0S,8,13,NA,NA,NA,NA
2021-04-23,Brown,Boston U.,Away,W,12,5,NA,12,6,18,48,27,34,18,9,5,2,7,31,16,29,18,9,60M 0S,5,11,60M 0S,12,15,NA,NA,NA,NA
2021-02-13,Bryant,Providence,Home,W,9,8,NA,9,8,17,37,21,34,20,8,8,5,13,43,24,32,16,7,60M 0S,8,16,60M 0S,9,12,NA,NA,NA,NA
2021-02-20,Bryant,Stony Brook,Away,L,8,14,NA,8,4,12,41,24,32,17,6,14,9,23,40,24,34,13,7,60M 0S,14,10,60M 0S,8,16,NA,NA,NA,NA
2021-02-27,Bryant,Vermont,Home,W,15,12,NA,15,8,23,42,28,46,19,11,12,6,18,36,21,39,20,8,60M 0S,12,9,60M 0S,15,13,NA,NA,NA,NA
2021-03-06,Bryant,Merrimack,Home,L,20,8,NA,20,10,30,61,41,31,13,9,8,7,15,23,17,26,16,11,60M 0S,8,9,60M 0S,20,21,NA,NA,NA,NA
2021-03-21,Bryant,Wagner,Away,W,18,5,NA,18,8,26,49,32,42,15,9,5,4,9,30,18,30,18,9,60M 0S,5,13,60M 0S,18,14,NA,NA,NA,NA
2021-03-27,Bryant,Merrimack,Away,L,11,10,NA,11,6,17,33,22,28,20,8,10,2,12,32,23,30,21,8,60M 0S,10,13,60M 0S,11,11,NA,NA,NA,NA
2021-04-03,Bryant,Hobart,Home,L,10,11,NA,10,6,16,49,33,40,18,12,11,3,14,41,25,33,21,7,60M 0S,11,14,60M 0S,10,23,NA,NA,NA,NA
2021-04-17,Bryant,Saint Joseph's,Home,W,5,13,NA,5,2,7,43,20,26,18,12,13,7,20,45,30,52,25,7,60M 0S,13,17,60M 0S,5,15,NA,NA,NA,NA
2021-04-24,Bryant,Sacred Heart,Away,L,20,12,NA,20,8,28,51,30,34,13,8,12,9,21,42,24,35,16,5,48M 48S,12,12,48M 48S,20,10,NA,NA,NA,NA
2021-04-27,Bryant,LIU,Away,L,20,17,NA,20,9,29,78,50,49,8,4,17,9,26,37,26,24,13,3,60M 0S,17,9,60M 0S,20,30,NA,NA,NA,NA
2021-05-05,Bryant,Hobart,Away,L,14,12,NA,14,4,18,36,22,28,19,6,12,8,20,59,29,38,15,12,60M 0S,12,17,60M 0S,14,8,NA,NA,NA,NA
2021-05-08,Bryant,Saint Joseph's,Away,L,16,10,NA,16,7,23,47,27,45,13,6,10,4,14,49,28,31,15,7,60M 0S,10,18,60M 0S,16,11,NA,NA,NA,NA
2021-05-16,Bryant,Virginia,Away,W,11,13,NA,11,6,17,47,29,31,12,5,13,9,22,38,21,44,11,8,60M 0S,13,8,60M 0S,11,18,NA,NA,NA,NA
2021-03-07,Bucknell,Cleveland St.,Home,L,15,9,NA,15,8,23,41,29,38,17,18,9,6,15,32,17,34,25,13,60M 0S,9,8,60M 0S,15,14,NA,NA,NA,NA
2021-03-14,Bucknell,Lehigh,Home,W,6,18,NA,6,5,11,38,21,20,15,7,18,14,32,50,33,52,16,12,60M 0S,18,15,60M 0S,6,15,NA,NA,NA,NA
2021-03-20,Bucknell,Loyola Maryland,Away,W,10,24,NA,10,8,18,37,23,37,15,6,24,20,44,51,33,44,11,10,60M 0S,24,9,60M 0S,10,13,NA,NA,NA,NA
2021-03-28,Bucknell,Navy,Away,W,10,13,NA,10,5,15,47,27,38,18,6,13,11,24,35,23,42,15,11,60M 0S,13,10,60M 0S,10,17,NA,NA,NA,NA
2021-04-03,Bucknell,Colgate,Home,W,9,10,NA,9,5,14,48,27,36,9,8,10,6,16,37,19,29,14,3,60M 0S,10,9,60M 0S,9,18,NA,NA,NA,NA
2021-04-10,Bucknell,Lafayette,Home,L,14,6,NA,14,9,23,53,30,43,15,16,6,3,9,41,21,23,21,7,60M 0S,6,15,60M 0S,14,16,NA,NA,NA,NA
2021-04-16,Bucknell,Robert Morris,Home,L,7,8,NA,7,3,10,31,20,29,18,13,8,6,14,34,17,40,23,12,60M 0S,8,9,60M 0S,7,13,NA,NA,NA,NA
2021-04-24,Bucknell,Lehigh,Away,W,12,18,NA,12,9,21,44,24,27,13,8,18,16,34,44,31,43,14,8,60M 0S,18,13,60M 0S,12,12,NA,NA,NA,NA
2021-03-06,Canisius,Siena,Away,L,8,7,NA,8,3,11,30,15,31,27,5,7,6,13,31,19,33,23,6,60M 0S,7,12,60M 0S,8,7,NA,NA,NA,NA
2021-03-13,Canisius,Manhattan,Home,W,7,10,NA,7,5,12,36,21,32,21,12,10,5,15,25,14,23,22,9,60M 0S,10,4,60M 0S,7,14,NA,NA,NA,NA
2021-03-20,Canisius,Siena,Away,L,12,10,NA,12,9,21,30,25,34,26,5,10,6,16,50,22,36,13,18,60M 0S,10,12,60M 0S,12,13,NA,NA,NA,NA
2021-04-02,Canisius,Detroit Mercy,Home,W,5,13,NA,5,3,8,29,19,24,19,7,13,8,21,40,25,24,21,5,60M 0S,13,12,60M 0S,5,14,NA,NA,NA,NA
2021-04-06,Canisius,St. Bonaventure,Home,L,11,9,NA,11,8,19,43,26,37,19,7,9,4,13,32,18,26,20,8,59M 43S,9,9,59M 43S,11,15,NA,NA,NA,NA
2021-04-11,Canisius,St. Bonaventure,Away,W,11,12,NA,11,3,14,45,26,25,11,9,12,8,20,39,23,30,15,7,60M 0S,12,11,60M 0S,11,15,NA,NA,NA,NA
2021-04-17,Canisius,Quinnipiac,Away,W,12,16,NA,12,4,16,52,27,19,13,9,16,11,27,47,27,29,19,9,60M 0S,16,11,60M 0S,12,15,NA,NA,NA,NA
2021-04-23,Canisius,Monmouth,Home,W,8,7,NA,8,6,14,33,19,23,17,8,7,1,8,41,20,35,21,7,60M 0S,7,13,60M 0S,8,11,NA,NA,NA,NA
2021-04-30,Canisius,Marist,Home,W,14,13,NA,14,9,23,42,22,36,23,7,13,8,21,46,27,27,17,11,60M 0S,13,14,60M 0S,14,8,NA,NA,NA,NA
2021-05-05,Canisius,Manhattan,Away,L,5,10,NA,5,4,9,29,17,24,20,6,10,5,15,38,24,33,17,10,60M 0S,10,14,60M 0S,5,12,NA,NA,NA,NA
2021-02-28,Cleveland St.,Mercer,Away,L,9,10,NA,9,5,14,28,19,26,22,10,10,5,15,42,27,24,21,9,60M 0S,10,17,60M 0S,9,10,NA,NA,NA,NA
2021-03-07,Cleveland St.,Bucknell,Away,L,9,15,NA,9,6,15,32,17,34,25,13,15,8,23,41,29,38,17,18,60M 0S,15,14,60M 0S,9,8,NA,NA,NA,NA
2021-03-13,Cleveland St.,Bellarmine,Away,L,8,1,NA,8,7,15,30,24,16,13,6,1,1,2,39,18,22,14,6,60M 0S,1,17,60M 0S,8,16,NA,NA,NA,NA
2021-03-20,Cleveland St.,Notre Dame,Away,L,5,19,NA,5,4,9,30,16,24,12,5,19,11,30,57,32,41,11,8,60M 0S,19,13,60M 0S,5,11,NA,NA,NA,NA
2021-03-27,Cleveland St.,Marquette,Away,L,5,10,NA,5,2,7,35,14,24,21,4,10,7,17,33,17,22,11,10,60M 0S,10,7,60M 0S,5,9,NA,NA,NA,NA
2021-04-03,Cleveland St.,VMI,Home,L,16,4,NA,16,13,29,52,26,39,17,6,4,0,4,33,15,15,17,8,60M 0S,4,11,60M 0S,16,10,NA,NA,NA,NA
2021-04-10,Cleveland St.,Robert Morris,Away,L,7,15,NA,7,2,9,31,17,25,30,6,15,7,22,53,32,38,16,14,60M 0S,15,17,60M 0S,7,10,NA,NA,NA,NA
2021-04-17,Cleveland St.,Bellarmine,Away,L,4,11,NA,4,4,8,16,7,23,27,12,11,8,19,27,16,26,23,17,60M 0S,11,5,60M 0S,4,3,NA,NA,NA,NA
2021-04-24,Cleveland St.,Utah,Home,W,9,11,NA,9,6,15,42,24,37,15,15,11,5,16,32,18,25,24,5,59M 15S,11,7,59M 15S,9,15,NA,NA,NA,NA
2021-05-01,Cleveland St.,VMI,Away,L,14,11,NA,14,3,17,31,21,35,27,7,11,7,18,41,18,29,16,17,60M 0S,11,7,60M 0S,14,7,NA,NA,NA,NA
2021-02-21,Colgate,Robert Morris,Home,L,14,17,NA,14,13,27,42,28,29,19,4,17,10,27,48,34,42,12,7,60M 0S,17,17,60M 0S,14,14,NA,NA,NA,NA
2021-02-27,Colgate,UAlbany,Away,L,9,15,NA,9,5,14,27,19,23,20,5,15,12,27,32,22,37,18,8,60M 0S,15,7,60M 0S,9,10,NA,NA,NA,NA
2021-03-06,Colgate,Holy Cross,Home,W,12,11,1,12,7,19,40,24,31,19,5,11,5,16,37,20,19,17,6,64M 0S,11,9,64M 0S,12,12,NA,NA,NA,NA
2021-03-20,Colgate,Boston U.,Away,W,11,16,NA,11,4,15,28,22,31,21,5,16,7,23,50,31,34,13,9,60M 0S,16,15,60M 0S,11,11,NA,NA,NA,NA
2021-03-28,Colgate,Lehigh,Home,L,10,15,NA,10,3,13,35,19,29,19,7,15,5,20,41,28,29,14,3,60M 0S,15,13,60M 0S,10,9,NA,NA,NA,NA
2021-04-03,Colgate,Bucknell,Away,W,10,9,NA,10,6,16,37,19,29,14,3,9,5,14,48,27,36,9,8,60M 0S,9,18,60M 0S,10,9,NA,NA,NA,NA
2021-04-10,Colgate,Boston U.,Home,L,10,14,NA,10,7,17,43,23,26,14,5,14,9,23,39,24,22,17,6,60M 0S,14,10,60M 0S,10,13,NA,NA,NA,NA
2021-04-30,Colgate,Army West Point,Away,W,11,13,NA,11,6,17,39,24,39,19,5,13,6,19,39,26,40,11,17,60M 0S,13,13,60M 0S,11,13,NA,NA,NA,NA
2021-05-04,Colgate,Boston U.,Away,W,11,8,NA,11,5,16,38,23,51,20,10,8,4,12,40,21,27,17,12,60M 0S,8,13,60M 0S,11,12,NA,NA,NA,NA
2021-05-07,Colgate,Lehigh,Away,L,9,13,NA,9,7,16,35,18,36,16,9,13,8,21,38,21,47,23,8,60M 0S,13,8,60M 0S,9,9,NA,NA,NA,NA
2021-04-25,Dartmouth,Tufts,Home,W,9,15,NA,9,7,16,37,20,34,26,10,15,14,29,74,35,34,14,15,60M 0S,15,20,60M 0S,9,11,NA,NA,NA,NA
2021-02-17,Delaware,Mount St. Mary's,Away,L,7,10,NA,7,3,10,25,17,18,17,5,10,4,14,39,27,34,12,10,60M 0S,10,17,60M 0S,7,10,NA,NA,NA,NA
2021-02-20,Delaware,NJIT,Away,W,15,4,NA,15,8,23,53,35,35,15,9,4,2,6,45,13,24,11,7,60M 0S,4,9,60M 0S,15,20,NA,NA,NA,NA
2021-02-23,Delaware,Saint Joseph's,Home,W,16,13,NA,16,9,25,39,22,35,13,9,13,6,19,54,29,35,17,8,60M 0S,13,16,60M 0S,16,6,NA,NA,NA,NA
2021-02-28,Delaware,Bellarmine,Home,W,14,11,NA,14,8,22,42,23,44,23,10,11,2,13,27,20,31,21,13,60M 0S,11,9,60M 0S,14,9,NA,NA,NA,NA
2021-03-06,Delaware,Fairfield,Away,W,17,9,NA,17,14,31,53,32,39,11,11,9,5,14,27,18,33,22,4,60M 0S,9,9,60M 0S,17,15,NA,NA,NA,NA
2021-03-13,Delaware,Drexel,Away,L,19,12,NA,19,8,27,49,25,29,16,8,12,7,19,37,23,34,16,6,60M 0S,12,11,60M 0S,19,6,NA,NA,NA,NA
2021-03-20,Delaware,Towson,Home,W,13,12,1,13,5,18,41,25,28,19,8,12,8,20,37,23,37,14,15,61M 19S,12,11,61M 19S,13,12,NA,NA,NA,NA
2021-04-02,Delaware,Fairfield,Home,W,16,11,NA,16,11,27,54,32,41,21,9,11,6,17,39,24,32,20,8,60M 0S,11,13,60M 0S,16,16,NA,NA,NA,NA
2021-04-10,Delaware,Drexel,Home,W,9,12,NA,9,7,16,40,21,35,12,3,12,5,17,40,26,34,12,7,60M 0S,12,14,60M 0S,9,12,NA,NA,NA,NA
2021-04-17,Delaware,Hofstra,Away,L,14,13,1,14,9,23,43,27,29,11,5,13,5,18,46,25,33,11,7,64M 0S,13,12,64M 0S,14,13,NA,NA,NA,NA
2021-04-24,Delaware,Towson,Away,W,16,8,NA,16,10,26,32,23,38,10,7,8,3,11,35,21,24,14,7,60M 0S,8,13,60M 0S,16,7,NA,NA,NA,NA
2021-04-30,Delaware,Massachusetts,Home,W,9,6,NA,9,3,12,43,23,37,18,11,6,3,9,32,19,29,17,8,60M 0S,6,13,60M 0S,9,14,NA,NA,NA,NA
2021-05-06,Delaware,Hofstra,Away,L,9,10,NA,9,5,14,45,20,38,10,4,10,0,10,31,17,22,12,3,60M 0S,10,7,60M 0S,9,11,NA,NA,NA,NA
2021-01-30,Denver,Utah,Home,W,9,8,NA,9,6,15,49,25,27,13,8,8,4,12,36,19,22,16,5,60M 0S,8,11,60M 0S,9,16,NA,NA,NA,NA
2021-02-05,Denver,Duke,Away,W,10,12,NA,10,5,15,45,24,30,15,3,12,4,16,30,19,17,11,6,60M 0S,12,7,60M 0S,10,14,NA,NA,NA,NA
2021-02-07,Denver,North Carolina,Away,W,13,24,NA,13,4,17,42,26,30,15,0,24,15,39,53,34,33,9,11,60M 0S,24,10,60M 0S,13,13,NA,NA,NA,NA
2021-02-13,Denver,Air Force,Away,W,15,6,NA,15,12,27,58,32,37,18,10,6,4,10,35,17,20,17,7,60M 0S,6,11,60M 0S,15,17,NA,NA,NA,NA
2021-02-20,Denver,Marquette,Away,W,10,9,NA,10,6,16,49,25,27,17,8,9,5,14,36,18,24,16,10,60M 0S,9,9,60M 0S,10,15,NA,NA,NA,NA
2021-02-27,Denver,Providence,Home,W,23,10,NA,23,18,41,48,31,34,11,9,10,3,13,42,21,25,16,5,60M 0S,10,11,60M 0S,23,8,NA,NA,NA,NA
2021-03-06,Denver,St. John's (NY),Away,W,20,6,NA,20,13,33,64,39,42,18,10,6,3,9,27,21,26,17,7,60M 0S,6,15,60M 0S,20,19,NA,NA,NA,NA
2021-03-16,Denver,Georgetown,Home,L,13,7,NA,13,8,21,39,25,23,15,8,7,5,12,46,19,30,17,7,60M 0S,7,12,60M 0S,13,12,NA,NA,NA,NA
2021-03-27,Denver,Providence,Away,L,19,11,NA,19,14,33,63,35,46,18,3,11,5,16,32,22,20,11,3,60M 0S,11,11,60M 0S,19,16,NA,NA,NA,NA
2021-04-03,Denver,Marquette,Home,L,16,6,NA,16,9,25,45,32,32,13,8,6,3,9,37,14,26,16,8,60M 0S,6,8,60M 0S,16,16,NA,NA,NA,NA
2021-04-10,Denver,Villanova,Home,W,17,10,NA,17,9,26,36,25,36,16,11,10,5,15,38,22,27,16,9,60M 0S,10,12,60M 0S,17,8,NA,NA,NA,NA
2021-04-17,Denver,Georgetown,Away,W,10,11,1,10,6,16,36,24,30,14,6,11,8,19,48,26,27,13,5,62M 52S,11,15,62M 52S,10,14,NA,NA,NA,NA
2021-04-24,Denver,St. John's (NY),Home,W,19,11,NA,19,11,30,57,35,44,14,7,11,9,20,33,15,13,13,4,60M 0S,11,4,60M 0S,19,16,NA,NA,NA,NA
2021-04-28,Denver,Villanova,Away,L,11,10,1,11,6,17,36,21,29,17,5,10,4,14,50,30,21,8,11,61M 3S,10,20,61M 3S,11,10,NA,NA,NA,NA
2021-05-06,Denver,Providence,Away,W,14,5,NA,14,10,24,51,28,29,10,4,5,2,7,38,19,30,14,5,60M 0S,5,14,60M 0S,14,14,NA,NA,NA,NA
2021-05-08,Denver,"Georgetown Providence, R.I.",Away,L,9,10,NA,9,4,13,42,24,26,14,5,10,7,17,27,20,25,15,9,60M 0S,10,10,60M 0S,9,15,NA,NA,NA,NA
2021-05-16,Denver,Loyola Maryland,Home,L,13,14,NA,13,7,20,48,29,37,16,6,14,8,22,36,21,22,12,8,60M 0S,14,7,60M 0S,13,16,NA,NA,NA,NA
2021-03-06,Detroit Mercy,Marist,Away,W,11,15,NA,11,5,16,44,25,28,15,12,15,9,24,44,24,32,16,5,60M 0S,15,9,60M 0S,11,14,NA,NA,NA,NA
2021-03-13,Detroit Mercy,St. Bonaventure,Home,L,11,7,NA,11,6,17,48,25,38,17,12,7,5,12,38,21,18,18,7,60M 0S,7,14,60M 0S,11,14,NA,NA,NA,NA
2021-03-20,Detroit Mercy,Manhattan,Away,L,7,11,NA,7,3,10,40,22,30,23,7,11,7,18,38,20,23,21,6,60M 0S,11,9,60M 0S,7,15,NA,NA,NA,NA
2021-03-27,Detroit Mercy,Siena,Home,L,11,9,NA,11,5,16,49,23,43,21,11,9,6,15,31,22,21,19,8,60M 0S,9,13,60M 0S,11,12,NA,NA,NA,NA
2021-04-02,Detroit Mercy,Canisius,Away,W,13,5,NA,13,8,21,40,25,24,21,5,5,3,8,29,19,24,19,7,60M 0S,5,14,60M 0S,13,12,NA,NA,NA,NA
2021-04-09,Detroit Mercy,Monmouth,Away,W,7,9,NA,7,4,11,32,21,36,17,11,9,4,13,26,20,26,19,7,60M 0S,9,11,60M 0S,7,14,NA,NA,NA,NA
2021-04-30,Detroit Mercy,St. Bonaventure,Away,L,8,11,NA,8,4,12,40,20,27,18,7,11,6,17,30,21,29,20,7,60M 0S,11,10,60M 0S,8,12,NA,NA,NA,NA
2021-03-06,Drexel,Towson,Home,W,12,10,NA,12,8,20,43,24,21,16,11,10,4,14,36,22,27,19,7,60M 0S,10,12,60M 0S,12,12,NA,NA,NA,NA
2021-03-13,Drexel,Delaware,Home,L,12,19,NA,12,7,19,37,23,34,16,6,19,8,27,49,25,29,16,8,60M 0S,19,6,60M 0S,12,11,NA,NA,NA,NA
2021-03-20,Drexel,Massachusetts,Away,L,7,13,NA,7,5,12,50,28,32,17,8,13,10,23,37,26,39,19,9,60M 0S,13,13,60M 0S,7,21,NA,NA,NA,NA
2021-03-24,Drexel,Lafayette,Home,L,24,8,NA,24,16,40,49,32,39,19,18,8,5,13,34,16,26,27,9,60M 0S,8,8,60M 0S,24,8,NA,NA,NA,NA
2021-03-27,Drexel,Robert Morris,Home,W,19,13,NA,19,10,29,51,33,41,20,7,13,5,18,45,27,34,18,9,60M 0S,13,14,60M 0S,19,14,NA,NA,NA,NA
2021-04-03,Drexel,Massachusetts,Home,W,12,11,NA,12,7,19,38,21,28,14,6,11,5,16,36,19,26,21,3,60M 0S,11,8,60M 0S,12,9,NA,NA,NA,NA
2021-04-10,Drexel,Delaware,Away,W,12,9,NA,12,5,17,40,26,34,12,7,9,7,16,40,21,35,12,3,60M 0S,9,12,60M 0S,12,14,NA,NA,NA,NA
2021-04-17,Drexel,Fairfield,Away,W,19,7,NA,19,11,30,60,32,44,15,9,7,4,11,35,16,19,20,7,60M 0S,7,9,60M 0S,19,13,NA,NA,NA,NA
2021-04-24,Drexel,Hofstra,Home,L,12,8,NA,12,7,19,38,22,25,19,9,8,2,10,41,20,24,20,9,60M 0S,8,12,60M 0S,12,10,NA,NA,NA,NA
2021-05-01,Drexel,Towson,Away,L,12,11,NA,12,4,16,51,26,31,11,4,11,8,19,42,22,29,14,4,60M 0S,11,11,60M 0S,12,14,NA,NA,NA,NA
2021-05-06,Drexel,"Massachusetts Hempstead, NY",Away,W,13,8,NA,13,8,21,48,31,34,13,11,8,3,11,31,18,21,22,5,60M 0S,8,10,60M 0S,13,18,NA,NA,NA,NA
2021-05-08,Drexel,Hofstra,Away,L,15,11,NA,15,8,23,44,24,33,12,8,11,6,17,32,22,31,16,6,60M 0S,11,11,60M 0S,15,9,NA,NA,NA,NA
2021-05-15,Drexel,"Notre Dame Denver, Colo.",Away,L,8,10,NA,8,2,10,42,25,34,15,9,10,3,13,47,25,37,16,4,60M 0S,10,15,60M 0S,8,17,NA,NA,NA,NA
2021-02-05,Duke,Denver,Home,W,12,10,NA,12,4,16,30,19,17,11,6,10,5,15,45,24,30,15,3,60M 0S,10,14,60M 0S,12,7,NA,NA,NA,NA
2021-02-07,Duke,Robert Morris,Home,W,16,12,NA,16,11,27,50,31,43,14,11,12,7,19,40,26,26,18,8,60M 0S,12,14,60M 0S,16,15,NA,NA,NA,NA
2021-02-13,Duke,Mercer,Home,L,17,8,NA,17,10,27,35,27,36,21,12,8,3,11,29,14,31,27,8,60M 0S,8,6,60M 0S,17,10,NA,NA,NA,NA
2021-02-20,Duke,Towson,Away,W,19,7,NA,19,9,28,50,32,41,16,4,7,5,12,28,16,26,16,6,60M 0S,7,9,60M 0S,19,13,NA,NA,NA,NA
2021-02-27,Duke,Air Force,Home,L,17,7,NA,17,13,30,42,29,32,15,8,7,5,12,24,16,19,22,7,60M 0S,7,9,60M 0S,17,12,NA,NA,NA,NA
2021-03-07,Duke,Richmond,Away,W,13,6,NA,13,6,19,34,21,24,15,2,6,4,10,39,21,23,11,6,60M 0S,6,15,60M 0S,13,8,NA,NA,NA,NA
2021-03-10,Duke,High Point,Home,L,27,8,NA,27,13,40,51,32,42,15,8,8,3,11,38,20,23,17,3,60M 0S,8,12,60M 0S,27,5,NA,NA,NA,NA
2021-03-14,Duke,Jacksonville,Away,W,17,6,NA,17,14,31,48,35,38,11,5,6,4,10,23,11,25,23,5,60M 0S,6,5,60M 0S,17,18,NA,NA,NA,NA
2021-03-25,Duke,Syracuse,Home,W,15,14,NA,15,8,23,41,28,31,16,6,14,9,23,36,24,15,16,5,60M 0S,14,10,60M 0S,15,13,NA,NA,NA,NA
2021-04-01,Duke,North Carolina,Home,W,12,11,1,12,6,18,51,26,38,16,6,11,6,17,46,28,34,13,9,63M 13S,11,17,63M 13S,12,14,NA,NA,NA,NA
2021-04-10,Duke,Notre Dame,Away,L,8,13,NA,8,6,14,36,20,25,22,3,13,6,19,44,24,22,12,9,60M 0S,13,11,60M 0S,8,12,NA,NA,NA,NA
2021-04-15,Duke,Virginia,Away,L,13,12,1,13,6,19,50,29,25,14,4,12,5,17,49,28,42,10,10,63M 28S,12,16,63M 28S,13,16,NA,NA,NA,NA
2021-04-22,Duke,Notre Dame,Home,W,13,12,1,13,4,17,41,27,29,15,6,12,6,18,40,22,27,17,5,61M 55S,12,10,61M 55S,13,14,NA,NA,NA,NA
2021-05-02,Duke,North Carolina,Away,W,12,15,NA,12,8,20,39,23,22,13,4,15,5,20,50,27,37,11,6,60M 0S,15,12,60M 0S,12,11,NA,NA,NA,NA
2021-05-16,Duke,"High Point Chapel Hill, N.C.",Away,L,16,10,NA,16,9,25,43,28,37,13,6,10,6,16,34,24,21,11,7,60M 0S,10,14,60M 0S,16,12,NA,NA,NA,NA
2021-05-23,Duke,"Loyola Maryland Notre Dame, Ind.",Away,W,10,9,1,10,6,16,39,27,33,13,10,9,6,15,36,17,23,14,4,63M 3S,9,8,63M 3S,10,17,NA,NA,NA,NA
2021-05-29,Duke,"Maryland East Hartford, Conn.",Away,L,5,14,NA,5,3,8,32,22,29,16,10,14,9,23,32,25,40,23,6,60M 0S,14,11,60M 0S,5,17,NA,NA,NA,NA
2021-03-03,Fairfield,Providence,Away,W,17,18,NA,17,11,28,53,31,34,16,5,18,8,26,63,34,27,11,6,60M 0S,18,16,60M 0S,17,14,NA,NA,NA,NA
2021-03-06,Fairfield,Delaware,Home,W,9,17,NA,9,5,14,27,18,33,22,4,17,14,31,53,32,39,11,11,60M 0S,17,15,60M 0S,9,9,NA,NA,NA,NA
2021-03-10,Fairfield,Lafayette,Home,W,13,11,NA,13,7,20,46,27,34,15,11,11,2,13,41,26,31,15,8,60M 0S,11,15,60M 0S,13,14,NA,NA,NA,NA
2021-03-14,Fairfield,Massachusetts,Away,L,9,13,NA,9,3,12,30,19,30,21,9,13,8,21,39,25,30,15,12,60M 0S,13,12,60M 0S,9,10,NA,NA,NA,NA
2021-03-17,Fairfield,Sacred Heart,Home,L,14,8,NA,14,11,25,54,27,33,20,8,8,4,12,39,18,23,19,5,60M 0S,8,10,60M 0S,14,13,NA,NA,NA,NA
2021-03-26,Fairfield,Hofstra,Home,W,7,15,NA,7,6,13,31,18,23,19,7,15,6,21,48,33,29,15,5,60M 0S,15,18,60M 0S,7,11,NA,NA,NA,NA
2021-04-02,Fairfield,Delaware,Away,W,11,16,NA,11,6,17,39,24,32,20,8,16,11,27,54,32,41,21,9,60M 0S,16,16,60M 0S,11,13,NA,NA,NA,NA
2021-04-10,Fairfield,Towson,Away,W,11,12,NA,11,6,17,41,21,37,15,7,12,8,20,49,22,30,15,10,60M 0S,12,10,60M 0S,11,10,NA,NA,NA,NA
2021-04-17,Fairfield,Drexel,Home,W,7,19,NA,7,4,11,35,16,19,20,7,19,11,30,60,32,44,15,9,60M 0S,19,13,60M 0S,7,9,NA,NA,NA,NA
2021-04-24,Fairfield,Massachusetts,Home,L,14,21,NA,14,10,24,43,21,24,15,8,21,15,36,45,33,42,17,8,60M 0S,21,12,60M 0S,14,7,NA,NA,NA,NA
2021-04-30,Fairfield,Hofstra,Away,W,14,18,NA,14,10,24,47,31,33,15,8,18,11,29,44,31,36,21,7,60M 0S,18,13,60M 0S,14,17,NA,NA,NA,NA
2021-02-21,Georgetown,Villanova,Away,L,16,1,NA,16,12,28,43,26,27,14,11,1,0,1,27,7,12,19,4,60M 0S,1,6,60M 0S,16,10,NA,NA,NA,NA
2021-02-27,Georgetown,St. John's (NY),Home,W,19,1,NA,19,16,35,47,33,40,26,13,1,0,1,25,15,29,23,10,60M 0S,1,14,60M 0S,19,14,NA,NA,NA,NA
2021-03-02,Georgetown,Mount St. Mary's,Away,W,17,5,NA,17,14,31,45,23,36,21,16,5,3,8,19,12,20,27,6,60M 0S,5,7,60M 0S,17,6,NA,NA,NA,NA
2021-03-06,Georgetown,Marquette,Home,W,20,13,NA,20,12,32,56,33,51,18,8,13,8,21,36,26,37,15,9,60M 0S,13,13,60M 0S,20,13,NA,NA,NA,NA
2021-03-16,Georgetown,Denver,Away,L,7,13,NA,7,5,12,46,19,30,17,7,13,8,21,39,25,23,15,8,60M 0S,13,12,60M 0S,7,12,NA,NA,NA,NA
2021-03-20,Georgetown,Providence,Away,W,14,9,NA,14,7,21,47,34,33,11,8,9,2,11,41,14,23,17,5,60M 0S,9,5,60M 0S,14,20,NA,NA,NA,NA
2021-03-27,Georgetown,Villanova,Home,W,8,7,NA,8,4,12,51,23,30,9,10,7,4,11,35,18,28,16,4,60M 0S,7,11,60M 0S,8,15,NA,NA,NA,NA
2021-04-03,Georgetown,St. John's (NY),Away,W,20,7,NA,20,20,40,63,38,50,12,8,7,6,13,26,14,21,22,4,60M 0S,7,7,60M 0S,20,18,NA,NA,NA,NA
2021-04-10,Georgetown,Marquette,Away,W,10,8,NA,10,10,20,43,20,28,16,9,8,3,11,29,17,21,18,5,60M 0S,8,9,60M 0S,10,10,NA,NA,NA,NA
2021-04-17,Georgetown,Denver,Home,W,11,10,1,11,8,19,48,26,27,13,5,10,6,16,36,24,30,14,6,62M 52S,10,14,62M 52S,11,15,NA,NA,NA,NA
2021-04-24,Georgetown,Providence,Home,L,14,5,NA,14,10,24,45,29,32,15,11,5,4,9,51,30,33,14,9,60M 0S,5,25,60M 0S,14,15,NA,NA,NA,NA
2021-04-29,Georgetown,Loyola Maryland,Away,L,9,11,NA,9,8,17,39,22,37,18,4,11,6,17,38,23,26,15,10,60M 0S,11,12,60M 0S,9,13,NA,NA,NA,NA
2021-05-06,Georgetown,"Villanova Providence, R.I.",Away,L,14,12,NA,14,11,25,39,21,32,20,6,12,4,16,44,29,25,10,9,60M 0S,12,17,60M 0S,14,7,NA,NA,NA,NA
2021-05-08,Georgetown,"Denver Providence, R.I.",Away,W,10,9,NA,10,7,17,27,20,25,15,9,9,4,13,42,24,26,14,5,60M 0S,9,15,60M 0S,10,10,NA,NA,NA,NA
2021-05-15,Georgetown,"Syracuse College Park, Md.",Away,W,18,8,NA,18,7,25,43,33,33,8,9,8,4,12,33,18,23,13,3,60M 0S,8,10,60M 0S,18,15,NA,NA,NA,NA
2021-05-22,Georgetown,"Virginia Hempstead, N.Y.",Away,L,3,14,NA,3,2,5,27,13,16,18,3,14,4,18,45,22,31,15,12,60M 0S,14,8,60M 0S,3,10,NA,NA,NA,NA
2021-03-06,Hartford,UAlbany,Home,W,6,16,NA,6,2,8,34,16,33,21,9,16,11,27,43,29,32,17,7,60M 0S,16,13,60M 0S,6,10,NA,NA,NA,NA
2021-03-13,Hartford,UMass Lowell,Away,W,10,12,NA,10,2,12,33,23,35,16,11,12,4,16,40,19,31,17,8,60M 0S,12,7,60M 0S,10,13,NA,NA,NA,NA
2021-03-20,Hartford,UMBC,Home,L,10,13,NA,10,4,14,37,20,27,14,6,13,6,19,30,22,25,14,8,60M 0S,13,9,60M 0S,10,10,NA,NA,NA,NA
2021-03-27,Hartford,Vermont,Away,L,9,14,NA,9,6,15,35,18,28,15,11,14,5,19,50,32,37,17,10,60M 0S,14,18,60M 0S,9,9,NA,NA,NA,NA
2021-04-03,Hartford,Stony Brook,Home,W,6,17,NA,6,3,9,30,20,21,15,8,17,9,26,56,27,44,16,3,60M 0S,17,10,60M 0S,6,14,NA,NA,NA,NA
2021-04-10,Hartford,Binghamton,Away,L,8,7,NA,8,2,10,38,24,35,20,14,7,5,12,29,21,35,25,11,60M 0S,7,14,60M 0S,8,16,NA,NA,NA,NA
2021-04-17,Hartford,NJIT,Home,L,14,9,NA,14,10,24,43,29,30,13,10,9,3,12,40,20,28,20,4,60M 0S,9,11,60M 0S,14,15,NA,NA,NA,NA
2021-02-13,High Point,Robert Morris,Home,W,21,15,NA,21,10,31,48,34,35,19,17,15,9,24,41,25,25,20,13,59M 19S,15,10,59M 19S,21,13,NA,NA,NA,NA
2021-02-16,High Point,North Carolina,Away,W,15,17,NA,15,7,22,35,25,34,12,7,17,12,29,67,35,45,17,6,60M 0S,17,18,60M 0S,15,10,NA,NA,NA,NA
2021-02-27,High Point,North Carolina,Away,W,12,27,NA,12,7,19,34,20,15,17,6,27,11,38,54,36,44,14,11,60M 0S,27,9,60M 0S,12,8,NA,NA,NA,NA
2021-03-03,High Point,Virginia,Away,W,11,12,NA,11,4,15,38,28,39,25,12,12,8,20,43,27,59,26,10,60M 0S,12,15,60M 0S,11,17,NA,NA,NA,NA
2021-03-10,High Point,Duke,Away,L,8,27,NA,8,3,11,38,20,23,17,3,27,13,40,51,32,42,15,8,60M 0S,27,5,60M 0S,8,12,NA,NA,NA,NA
2021-03-19,High Point,VMI,Away,L,20,12,NA,20,13,33,38,29,36,19,6,12,4,16,31,20,28,20,11,60M 0S,12,8,60M 0S,20,9,NA,NA,NA,NA
2021-03-26,High Point,Richmond,Away,W,10,17,NA,10,2,12,34,23,23,17,7,17,13,30,50,34,31,14,14,60M 0S,17,17,60M 0S,10,13,NA,NA,NA,NA
2021-04-03,High Point,Bellarmine,Home,L,13,5,NA,13,12,25,33,17,36,21,5,5,5,10,33,17,20,11,6,60M 0S,5,12,60M 0S,13,4,NA,NA,NA,NA
2021-04-17,High Point,Mercer,Home,W,16,10,NA,16,8,24,48,28,27,15,10,10,9,19,34,23,27,19,6,60M 0S,10,13,60M 0S,16,12,NA,NA,NA,NA
2021-04-24,High Point,Air Force,Away,W,13,8,NA,13,8,21,45,25,31,16,6,8,5,13,45,20,27,11,11,60M 0S,8,12,60M 0S,13,12,NA,NA,NA,NA
2021-05-01,High Point,Jacksonville,Home,W,16,11,NA,16,12,28,39,22,32,16,6,11,6,17,42,25,27,13,3,59M 50S,11,14,59M 50S,16,6,NA,NA,NA,NA
2021-05-05,High Point,"Jacksonville Richmond, Va.",Away,W,11,9,NA,11,5,16,33,18,21,13,4,9,8,17,38,20,22,14,7,60M 0S,9,11,60M 0S,11,7,NA,NA,NA,NA
2021-05-07,High Point,Richmond,Away,W,11,8,NA,11,4,15,28,22,26,21,3,8,4,12,30,20,23,13,16,60M 0S,8,12,60M 0S,11,11,NA,NA,NA,NA
2021-05-16,High Point,"Duke Chapel Hill, N.C.",Away,W,10,16,NA,10,6,16,34,24,21,11,7,16,9,25,43,28,37,13,6,60M 0S,16,12,60M 0S,10,14,NA,NA,NA,NA
2021-03-06,Hobart Statesmen,Mount St. Mary's,Home,L,13,9,NA,13,5,18,53,29,32,15,6,9,5,14,50,25,23,11,8,60M 0S,9,16,60M 0S,13,16,NA,NA,NA,NA
2021-03-13,Hobart Statesmen,LIU,Away,W,12,14,NA,12,6,18,53,36,24,14,2,14,6,20,40,26,24,11,6,60M 0S,14,12,60M 0S,12,24,NA,NA,NA,NA
2021-03-20,Hobart Statesmen,Mount St. Mary's,Away,W,13,9,NA,13,5,18,42,24,33,19,4,9,4,13,40,22,39,13,7,60M 0S,9,13,60M 0S,13,11,NA,NA,NA,NA
2021-04-03,Hobart Statesmen,Bryant,Away,L,11,10,NA,11,3,14,41,25,33,21,7,10,6,16,49,33,40,18,12,60M 0S,10,23,60M 0S,11,14,NA,NA,NA,NA
2021-04-10,Hobart Statesmen,Saint Joseph's,Home,L,12,13,1,12,4,16,44,22,32,19,9,13,9,22,50,28,27,17,7,61M 28S,13,15,61M 28S,12,10,NA,NA,NA,NA
2021-04-24,Hobart Statesmen,Merrimack,Home,W,14,10,NA,14,10,24,50,28,34,14,10,10,5,15,37,20,18,16,6,60M 0S,10,10,60M 0S,14,14,NA,NA,NA,NA
2021-04-27,Hobart Statesmen,Wagner,Away,L,9,8,1,9,6,15,49,21,29,12,5,8,1,9,28,14,23,19,4,60M 47S,8,6,60M 47S,9,12,NA,NA,NA,NA
2021-05-01,Hobart Statesmen,Sacred Heart,Home,W,14,12,NA,14,10,24,49,28,46,19,10,12,5,17,38,20,20,14,6,60M 0S,12,8,60M 0S,14,14,NA,NA,NA,NA
2021-05-05,Hobart Statesmen,Bryant,Home,L,12,14,NA,12,8,20,59,29,38,15,12,14,4,18,36,22,28,19,6,60M 0S,14,8,60M 0S,12,17,NA,NA,NA,NA
2021-02-13,Hofstra,St. John's (NY),Home,L,18,19,1,18,10,28,35,24,43,29,6,19,10,29,53,31,38,12,12,61M 29S,19,12,61M 29S,18,6,NA,NA,NA,NA
2021-02-20,Hofstra,Sacred Heart,Away,W,13,6,NA,13,7,20,44,25,30,11,7,6,3,9,32,17,19,11,5,60M 0S,6,11,60M 0S,13,12,NA,NA,NA,NA
2021-02-27,Hofstra,Stony Brook,Home,W,20,17,NA,20,9,29,41,28,33,17,4,17,9,26,52,33,32,11,6,60M 0S,17,16,60M 0S,20,8,NA,NA,NA,NA
2021-03-02,Hofstra,Wagner,Home,L,18,6,NA,18,10,28,45,31,33,13,11,6,3,9,22,11,20,28,2,60M 0S,6,5,60M 0S,18,13,NA,NA,NA,NA
2021-03-26,Hofstra,Fairfield,Away,W,15,7,NA,15,6,21,48,33,29,15,5,7,6,13,31,18,23,19,7,60M 0S,7,11,60M 0S,15,18,NA,NA,NA,NA
2021-03-30,Hofstra,Massachusetts,Home,L,10,16,NA,10,5,15,37,23,28,15,6,16,12,28,34,23,36,20,6,60M 0S,16,7,60M 0S,10,13,NA,NA,NA,NA
2021-04-03,Hofstra,Towson,Home,W,8,7,NA,8,5,13,31,18,26,22,3,7,6,13,31,19,19,17,5,60M 0S,7,12,60M 0S,8,10,NA,NA,NA,NA
2021-04-09,Hofstra,Massachusetts,Away,L,12,11,NA,12,8,20,36,25,37,18,7,11,6,17,31,18,28,19,10,60M 0S,11,7,60M 0S,12,13,NA,NA,NA,NA
2021-04-13,Hofstra,Towson,Away,L,8,10,NA,8,3,11,36,22,35,12,9,10,5,15,36,17,21,13,9,60M 0S,10,7,60M 0S,8,14,NA,NA,NA,NA
2021-04-17,Hofstra,Delaware,Home,L,13,14,1,13,5,18,46,25,33,11,7,14,9,23,43,27,29,11,5,64M 0S,14,13,64M 0S,13,12,NA,NA,NA,NA
2021-04-24,Hofstra,Drexel,Away,L,8,12,NA,8,2,10,41,20,24,20,9,12,7,19,38,22,25,19,9,60M 0S,12,10,60M 0S,8,12,NA,NA,NA,NA
2021-04-30,Hofstra,Fairfield,Home,W,18,14,NA,18,11,29,44,31,36,21,7,14,10,24,47,31,33,15,8,60M 0S,14,17,60M 0S,18,13,NA,NA,NA,NA
2021-05-06,Hofstra,Delaware,Home,L,10,9,NA,10,0,10,31,17,22,12,3,9,5,14,45,20,38,10,4,60M 0S,9,11,60M 0S,10,7,NA,NA,NA,NA
2021-05-08,Hofstra,Drexel,Home,L,11,15,NA,11,6,17,32,22,31,16,6,15,8,23,44,24,33,12,8,60M 0S,15,9,60M 0S,11,11,NA,NA,NA,NA
2021-02-27,Holy Cross,Sacred Heart,Home,W,11,10,NA,11,6,17,40,25,29,13,10,10,7,17,43,28,30,16,1,60M 0S,10,18,60M 0S,11,14,NA,NA,NA,NA
2021-03-06,Holy Cross,Colgate,Away,W,11,12,1,11,5,16,37,20,19,17,6,12,7,19,40,24,31,19,5,64M 0S,12,12,64M 0S,11,9,NA,NA,NA,NA
2021-03-12,Holy Cross,Boston U.,Home,W,6,16,NA,6,3,9,34,22,29,25,8,16,13,29,42,27,24,16,11,60M 0S,16,11,60M 0S,6,16,NA,NA,NA,NA
2021-03-20,Holy Cross,Syracuse,Away,L,6,15,NA,6,2,8,20,11,28,24,8,15,9,24,65,34,38,11,14,60M 0S,15,19,60M 0S,6,5,NA,NA,NA,NA
2021-03-27,Holy Cross,Army West Point,Away,L,3,13,NA,3,2,5,27,14,20,17,6,13,12,25,45,29,36,11,9,60M 0S,13,16,60M 0S,3,11,NA,NA,NA,NA
2021-04-04,Holy Cross,Lafayette,Home,L,10,7,NA,10,9,19,34,19,23,19,12,7,5,12,27,18,20,18,12,60M 0S,7,11,60M 0S,10,9,NA,NA,NA,NA
2021-02-10,Jacksonville,Bellarmine,Home,L,19,8,NA,19,17,36,46,28,42,15,11,8,6,14,22,12,20,17,8,60M 0S,8,4,60M 0S,19,9,NA,NA,NA,NA
2021-02-13,Jacksonville,North Carolina,Away,L,7,18,NA,7,4,11,24,14,23,18,5,18,7,25,53,30,34,12,7,60M 0S,18,12,60M 0S,7,7,NA,NA,NA,NA
2021-02-20,Jacksonville,"Mercer Savannah, Ga.",Away,L,12,11,1,12,10,22,42,29,24,15,9,11,6,17,42,23,32,20,3,62M 38S,11,12,62M 38S,12,17,NA,NA,NA,NA
2021-02-28,Jacksonville,Navy,Away,L,6,13,NA,6,5,11,29,15,28,20,11,13,5,18,31,21,43,14,9,60M 0S,13,8,60M 0S,6,9,NA,NA,NA,NA
2021-03-06,Jacksonville,Utah,Away,L,8,3,NA,8,2,10,40,20,33,11,7,3,2,5,16,6,18,21,5,60M 0S,3,3,60M 0S,8,12,NA,NA,NA,NA
2021-03-14,Jacksonville,Duke,Home,W,6,17,NA,6,4,10,23,11,25,23,5,17,14,31,48,35,38,11,5,60M 0S,17,18,60M 0S,6,5,NA,NA,NA,NA
2021-03-21,Jacksonville,Mercer,Away,W,16,6,NA,16,9,25,45,35,27,27,10,6,4,10,34,17,22,24,21,60M 0S,6,11,60M 0S,16,19,NA,NA,NA,NA
2021-03-27,Jacksonville,VMI,Home,W,18,12,NA,18,11,29,44,32,50,24,11,12,7,19,42,24,33,18,13,60M 0S,12,12,60M 0S,18,14,NA,NA,NA,NA
2021-04-03,Jacksonville,"Robert Morris Fort Mill, S.C.",Away,W,15,16,NA,15,8,23,28,19,26,14,1,16,8,24,44,34,35,17,10,60M 0S,16,17,60M 0S,15,7,NA,NA,NA,NA
2021-04-10,Jacksonville,Air Force,Home,L,11,5,NA,11,4,15,41,22,34,22,8,5,1,6,44,21,28,13,8,60M 0S,5,16,60M 0S,11,11,NA,NA,NA,NA
2021-04-17,Jacksonville,Richmond,Away,L,7,14,NA,7,5,12,30,19,22,17,4,14,9,23,39,21,30,20,8,60M 0S,14,7,60M 0S,7,12,NA,NA,NA,NA
2021-04-24,Jacksonville,Bellarmine,Home,W,8,7,NA,8,4,12,35,24,28,16,10,7,3,10,30,15,17,15,6,60M 0S,7,8,60M 0S,8,16,NA,NA,NA,NA
2021-05-01,Jacksonville,High Point,Away,W,11,16,NA,11,6,17,42,25,27,13,3,16,12,28,39,22,32,16,6,59M 50S,16,6,59M 50S,11,14,NA,NA,NA,NA
2021-05-05,Jacksonville,"High Point Richmond, Va.",Away,L,9,11,NA,9,8,17,38,20,22,14,7,11,5,16,33,18,21,13,4,60M 0S,11,7,60M 0S,9,11,NA,NA,NA,NA
2021-02-20,Johns Hopkins,Ohio St.,Home,W,8,14,NA,8,3,11,32,19,26,19,5,14,3,17,37,27,33,16,5,60M 0S,14,13,60M 0S,8,11,NA,NA,NA,NA
2021-02-27,Johns Hopkins,Michigan,Away,W,14,7,NA,14,10,24,33,21,28,15,8,7,4,11,34,13,31,21,7,60M 0S,7,6,60M 0S,14,7,NA,NA,NA,NA
2021-03-06,Johns Hopkins,Maryland,Away,W,10,18,NA,10,7,17,33,24,20,15,4,18,13,31,41,27,31,10,10,60M 0S,18,9,60M 0S,10,14,NA,NA,NA,NA
2021-03-13,Johns Hopkins,Penn St.,Home,L,13,6,NA,13,6,19,46,27,28,10,9,6,2,8,22,12,25,20,5,60M 0S,6,6,60M 0S,13,14,NA,NA,NA,NA
2021-03-20,Johns Hopkins,Rutgers,Home,W,9,15,NA,9,5,14,31,21,27,18,6,15,12,27,46,21,26,13,7,60M 0S,15,6,60M 0S,9,12,NA,NA,NA,NA
2021-03-28,Johns Hopkins,Penn St.,Away,L,8,11,NA,8,4,12,39,23,39,14,11,11,8,19,39,20,35,22,7,60M 0S,11,9,60M 0S,8,15,NA,NA,NA,NA
2021-04-04,Johns Hopkins,Michigan,Home,L,10,13,NA,10,8,18,38,26,35,16,9,13,6,19,34,21,27,20,6,60M 0S,13,8,60M 0S,10,16,NA,NA,NA,NA
2021-04-10,Johns Hopkins,Ohio St.,Away,W,12,14,NA,12,5,17,37,19,31,15,4,14,9,23,39,22,30,14,6,60M 0S,14,8,60M 0S,12,7,NA,NA,NA,NA
2021-04-17,Johns Hopkins,Rutgers,Away,W,11,17,NA,11,7,18,33,26,22,17,4,17,11,28,44,28,30,9,7,60M 0S,17,11,60M 0S,11,15,NA,NA,NA,NA
2021-04-24,Johns Hopkins,Maryland,Home,L,13,14,NA,13,8,21,38,23,30,13,6,14,6,20,39,25,33,12,5,60M 0S,14,11,60M 0S,13,10,NA,NA,NA,NA
2021-05-01,Johns Hopkins,Penn St.,Away,W,15,7,NA,15,9,24,31,21,28,13,10,7,5,12,36,19,28,17,5,60M 0S,7,12,60M 0S,15,6,NA,NA,NA,NA
2021-05-06,Johns Hopkins,"Rutgers University Park, Pa.",Away,L,12,10,NA,12,4,16,36,24,34,16,5,10,4,14,42,22,26,13,5,60M 0S,10,12,60M 0S,12,12,NA,NA,NA,NA
2021-05-08,Johns Hopkins,"Maryland University Park, Pa.",Away,W,10,12,NA,10,4,14,33,17,37,18,9,12,7,19,33,15,25,16,7,60M 0S,12,3,60M 0S,10,7,NA,NA,NA,NA
2021-02-24,LIU,Sacred Heart,Away,W,10,12,NA,10,6,16,38,25,26,24,1,12,4,16,62,33,42,9,13,47M 33S,12,21,47M 33S,10,15,NA,NA,NA,NA
2021-02-27,LIU,Wagner,Home,L,19,8,NA,19,13,32,42,34,35,18,8,8,6,14,22,16,24,21,5,60M 0S,8,8,60M 0S,19,15,NA,NA,NA,NA
2021-03-06,LIU,Sacred Heart,Away,L,13,10,NA,13,9,22,39,31,35,12,3,10,5,15,44,28,23,11,4,60M 0S,10,18,60M 0S,13,18,NA,NA,NA,NA
2021-03-13,LIU,Hobart,Home,W,14,12,NA,14,6,20,40,26,24,11,6,12,6,18,53,36,24,14,2,60M 0S,12,24,60M 0S,14,12,NA,NA,NA,NA
2021-03-20,LIU,Sacred Heart,Home,L,13,8,NA,13,7,20,51,33,40,20,4,8,6,14,43,27,28,14,4,60M 0S,8,19,60M 0S,13,20,NA,NA,NA,NA
2021-03-27,LIU,Wagner,Away,L,18,13,NA,18,12,30,42,33,38,12,7,13,11,24,53,26,34,14,6,60M 0S,13,13,60M 0S,18,15,NA,NA,NA,NA
2021-04-03,LIU,Merrimack,Away,W,10,14,NA,10,7,17,35,24,33,18,11,14,4,18,39,26,27,20,10,60M 0S,14,12,60M 0S,10,14,NA,NA,NA,NA
2021-04-17,LIU,Mount St. Mary's,Home,W,17,15,NA,17,10,27,42,26,36,17,5,15,10,25,40,31,37,14,11,58M 51S,15,16,58M 51S,17,9,NA,NA,NA,NA
2021-04-24,LIU,Saint Joseph's,Away,W,13,14,NA,13,10,23,30,19,27,18,5,14,11,25,48,33,30,17,12,60M 0S,14,19,60M 0S,13,6,NA,NA,NA,NA
2021-04-27,LIU,Bryant,Home,L,17,20,NA,17,9,26,37,26,24,13,3,20,9,29,78,50,49,8,4,60M 0S,20,30,60M 0S,17,9,NA,NA,NA,NA
2021-05-05,LIU,Saint Joseph's,Away,W,11,19,NA,11,4,15,28,16,24,21,11,19,15,34,45,32,45,13,16,60M 0S,19,13,60M 0S,11,5,NA,NA,NA,NA
2021-03-06,Lafayette,VMI,Home,L,12,13,NA,12,9,21,30,18,37,19,8,13,9,22,44,27,43,15,14,60M 0S,13,14,60M 0S,12,6,NA,NA,NA,NA
2021-03-10,Lafayette,Fairfield,Away,W,11,13,NA,11,2,13,41,26,31,15,8,13,7,20,46,27,34,15,11,60M 0S,13,14,60M 0S,11,15,NA,NA,NA,NA
2021-03-13,Lafayette,Loyola Maryland,Away,L,6,16,NA,6,2,8,23,11,28,23,4,16,8,24,57,35,39,11,13,60M 0S,16,19,60M 0S,6,5,NA,NA,NA,NA
2021-03-24,Lafayette,Drexel,Away,L,8,24,NA,8,5,13,34,16,26,27,9,24,16,40,49,32,39,19,18,60M 0S,24,8,60M 0S,8,8,NA,NA,NA,NA
2021-03-27,Lafayette,Boston U.,Home,W,9,13,NA,9,5,14,40,25,42,19,13,13,7,20,38,28,37,21,11,60M 0S,13,15,60M 0S,9,16,NA,NA,NA,NA
2021-04-04,Lafayette,Holy Cross,Away,L,7,10,NA,7,5,12,27,18,20,18,12,10,9,19,34,19,23,19,12,60M 0S,10,9,60M 0S,7,11,NA,NA,NA,NA
2021-04-10,Lafayette,Bucknell,Away,L,6,14,NA,6,3,9,41,21,23,21,7,14,9,23,53,30,43,15,16,60M 0S,14,16,60M 0S,6,15,NA,NA,NA,NA
2021-04-16,Lafayette,Lehigh,Home,L,11,18,NA,11,5,16,33,23,26,7,6,18,9,27,47,33,45,13,6,60M 0S,18,15,60M 0S,11,12,NA,NA,NA,NA
2021-04-18,Lafayette,Lehigh,Away,W,11,14,NA,11,6,17,28,21,31,11,6,14,8,22,48,28,40,14,7,60M 0S,14,14,60M 0S,11,10,NA,NA,NA,NA
2021-04-24,Lafayette,Loyola Maryland,Home,W,7,11,NA,7,4,11,25,16,36,18,7,11,7,18,36,19,33,16,12,60M 0S,11,8,60M 0S,7,9,NA,NA,NA,NA
2021-05-01,Lafayette,Navy,Home,L,10,14,NA,10,2,12,41,24,24,10,5,14,6,20,34,22,37,14,4,60M 0S,14,8,60M 0S,10,14,NA,NA,NA,NA
2021-02-27,Lehigh,NJIT,Home,W,24,10,NA,24,15,39,54,38,44,8,8,10,5,15,34,20,29,13,5,60M 0S,10,10,60M 0S,24,14,NA,NA,NA,NA
2021-03-06,Lehigh,Loyola Maryland,Home,L,10,6,NA,10,4,14,46,21,49,16,11,6,4,10,29,23,23,12,7,60M 0S,6,17,60M 0S,10,11,NA,NA,NA,NA
2021-03-14,Lehigh,Bucknell,Away,W,18,6,NA,18,14,32,50,33,52,16,12,6,5,11,38,21,20,15,7,60M 0S,6,15,60M 0S,18,15,NA,NA,NA,NA
2021-03-28,Lehigh,Colgate,Away,L,15,10,NA,15,5,20,41,28,29,14,3,10,3,13,35,19,29,19,7,60M 0S,10,9,60M 0S,15,13,NA,NA,NA,NA
2021-04-03,Lehigh,Army West Point,Home,W,13,12,NA,13,7,20,40,24,51,21,9,12,5,17,41,22,33,16,10,60M 0S,12,10,60M 0S,13,11,NA,NA,NA,NA
2021-04-10,Lehigh,Navy,Home,L,13,7,NA,13,11,24,55,28,42,11,4,7,4,11,36,21,25,10,2,60M 0S,7,14,60M 0S,13,15,NA,NA,NA,NA
2021-04-16,Lehigh,Lafayette,Away,L,18,11,NA,18,9,27,47,33,45,13,6,11,5,16,33,23,26,7,6,60M 0S,11,12,60M 0S,18,15,NA,NA,NA,NA
2021-04-18,Lehigh,Lafayette,Home,W,14,11,NA,14,8,22,48,28,40,14,7,11,6,17,28,21,31,11,6,60M 0S,11,10,60M 0S,14,14,NA,NA,NA,NA
2021-04-24,Lehigh,Bucknell,Home,W,18,12,NA,18,16,34,44,31,43,14,8,12,9,21,44,24,27,13,8,60M 0S,12,12,60M 0S,18,13,NA,NA,NA,NA
2021-05-01,Lehigh,Villanova,Away,L,8,16,NA,8,2,10,41,18,30,24,5,16,10,26,43,30,24,14,15,60M 0S,16,14,60M 0S,8,10,NA,NA,NA,NA
2021-05-07,Lehigh,Colgate,Home,L,13,9,NA,13,8,21,38,21,47,23,8,9,7,16,35,18,36,16,9,60M 0S,9,9,60M 0S,13,8,NA,NA,NA,NA
2021-05-15,Lehigh,"Rutgers Charlottesville, Va.",Away,L,5,12,NA,5,4,9,35,22,31,14,6,12,7,19,42,29,30,12,10,60M 0S,12,17,60M 0S,5,17,NA,NA,NA,NA
2021-02-14,Loyola Maryland,Richmond,Away,L,8,7,1,8,5,13,36,20,28,19,11,7,3,10,32,17,26,18,12,61M 1S,7,10,61M 1S,8,12,NA,NA,NA,NA
2021-02-20,Loyola Maryland,Virginia,Home,L,12,15,NA,12,5,17,46,21,36,14,7,15,3,18,50,25,26,11,4,60M 0S,15,10,60M 0S,12,9,NA,NA,NA,NA
2021-02-27,Loyola Maryland,Utah,Home,L,20,8,NA,20,11,31,49,27,31,13,10,8,4,12,30,15,23,15,3,60M 0S,8,7,60M 0S,20,7,NA,NA,NA,NA
2021-03-06,Loyola Maryland,Lehigh,Away,L,6,10,NA,6,4,10,29,23,23,12,7,10,4,14,46,21,49,16,11,60M 0S,10,11,60M 0S,6,17,NA,NA,NA,NA
2021-03-13,Loyola Maryland,Lafayette,Home,L,16,6,NA,16,8,24,57,35,39,11,13,6,2,8,23,11,28,23,4,60M 0S,6,5,60M 0S,16,19,NA,NA,NA,NA
2021-03-20,Loyola Maryland,Bucknell,Home,W,24,10,NA,24,20,44,51,33,44,11,10,10,8,18,37,23,37,15,6,60M 0S,10,13,60M 0S,24,9,NA,NA,NA,NA
2021-03-27,Loyola Maryland,Towson,Away,W,6,7,1,6,2,8,34,14,27,16,6,7,1,8,38,15,28,13,2,62M 41S,7,8,62M 41S,6,8,NA,NA,NA,NA
2021-04-03,Loyola Maryland,Navy,Away,L,14,10,NA,14,9,23,40,27,40,20,5,10,7,17,40,22,36,12,8,60M 0S,10,12,60M 0S,14,13,NA,NA,NA,NA
2021-04-10,Loyola Maryland,Army West Point,Home,W,7,12,NA,7,4,11,45,23,39,11,8,12,4,16,35,18,26,15,5,60M 0S,12,6,60M 0S,7,16,NA,NA,NA,NA
2021-04-17,Loyola Maryland,Navy,Home,L,12,14,NA,12,6,18,42,27,45,15,9,14,10,24,42,27,39,18,9,60M 0S,14,13,60M 0S,12,15,NA,NA,NA,NA
2021-04-24,Loyola Maryland,Lafayette,Away,W,11,7,NA,11,7,18,36,19,33,16,12,7,4,11,25,16,36,18,7,60M 0S,7,9,60M 0S,11,8,NA,NA,NA,NA
2021-04-29,Loyola Maryland,Georgetown,Home,L,11,9,NA,11,6,17,38,23,26,15,10,9,8,17,39,22,37,18,4,60M 0S,9,13,60M 0S,11,12,NA,NA,NA,NA
2021-05-04,Loyola Maryland,Navy,Home,L,16,9,NA,16,9,25,46,30,40,12,8,9,6,15,30,18,25,14,3,60M 0S,9,9,60M 0S,16,14,NA,NA,NA,NA
2021-05-07,Loyola Maryland,"Army West Point Bethlehem, Pa.",Away,L,11,10,NA,11,7,18,34,23,36,14,8,10,6,16,43,22,40,17,7,60M 0S,10,12,60M 0S,11,12,NA,NA,NA,NA
2021-05-16,Loyola Maryland,Denver,Away,L,14,13,NA,14,8,22,36,21,22,12,8,13,7,20,48,29,37,16,6,60M 0S,13,16,60M 0S,14,7,NA,NA,NA,NA
2021-05-23,Loyola Maryland,"Duke Notre Dame, Ind.",Away,L,9,10,1,9,6,15,36,17,23,14,4,10,6,16,39,27,33,13,10,63M 3S,10,17,63M 3S,9,8,NA,NA,NA,NA
2021-03-06,Manhattan,Monmouth,Away,W,5,8,NA,5,2,7,25,14,24,20,8,8,6,14,34,23,27,18,10,60M 0S,8,15,60M 0S,5,9,NA,NA,NA,NA
2021-03-13,Manhattan,Canisius,Away,W,10,7,NA,10,5,15,25,14,23,22,9,7,5,12,36,21,32,21,12,60M 0S,7,14,60M 0S,10,4,NA,NA,NA,NA
2021-03-20,Manhattan,Detroit Mercy,Home,L,11,7,NA,11,7,18,38,20,23,21,6,7,3,10,40,22,30,23,7,60M 0S,7,15,60M 0S,11,9,NA,NA,NA,NA
2021-03-26,Manhattan,Monmouth,Home,W,9,8,2,9,6,15,37,19,14,13,9,8,5,13,37,19,34,23,7,67M 42S,8,11,67M 42S,9,10,NA,NA,NA,NA
2021-04-02,Manhattan,St. Bonaventure,Away,W,8,9,NA,8,4,12,36,22,24,10,7,9,8,17,29,19,32,19,6,60M 0S,9,10,60M 0S,8,15,NA,NA,NA,NA
2021-04-10,Manhattan,Quinnipiac,Away,W,12,13,2,12,7,19,42,21,16,17,9,13,6,19,48,24,37,24,9,66M 46S,13,11,66M 46S,12,9,NA,NA,NA,NA
2021-04-17,Manhattan,Siena,Home,W,13,12,2,13,6,19,50,30,34,17,11,12,5,17,55,27,44,19,10,67M 33S,12,15,67M 33S,13,17,NA,NA,NA,NA
2021-04-24,Manhattan,Marist,Away,L,7,14,NA,7,2,9,43,20,30,15,6,14,7,21,58,31,32,13,8,60M 0S,14,17,60M 0S,7,13,NA,NA,NA,NA
2021-05-05,Manhattan,Canisius,Home,L,10,5,NA,10,5,15,38,24,33,17,10,5,4,9,29,17,24,20,6,60M 0S,5,12,60M 0S,10,14,NA,NA,NA,NA
2021-05-08,Manhattan,Monmouth,Home,W,9,14,NA,9,6,15,28,19,17,12,7,14,3,17,32,20,33,21,7,60M 0S,14,6,60M 0S,9,10,NA,NA,NA,NA
2021-03-06,Marist,Detroit Mercy,Home,W,15,11,NA,15,9,24,44,24,32,16,5,11,5,16,44,25,28,15,12,60M 0S,11,14,60M 0S,15,9,NA,NA,NA,NA
2021-04-20,Marist,Quinnipiac,Home,L,14,9,NA,14,6,20,46,28,22,15,10,9,3,12,50,23,39,22,9,60M 0S,9,14,60M 0S,14,14,NA,NA,NA,NA
2021-04-24,Marist,Manhattan,Home,L,14,7,NA,14,7,21,58,31,32,13,8,7,2,9,43,20,30,15,6,60M 0S,7,13,60M 0S,14,17,NA,NA,NA,NA
2021-04-30,Marist,Canisius,Away,W,13,14,NA,13,8,21,46,27,27,17,11,14,9,23,42,22,36,23,7,60M 0S,14,8,60M 0S,13,14,NA,NA,NA,NA
2021-02-20,Marquette,Denver,Home,W,9,10,NA,9,5,14,36,18,24,16,10,10,6,16,49,25,27,17,8,60M 0S,10,15,60M 0S,9,9,NA,NA,NA,NA
2021-02-27,Marquette,Villanova,Home,L,14,16,NA,14,9,23,39,21,28,11,5,16,7,23,51,31,22,10,3,60M 0S,16,15,60M 0S,14,7,NA,NA,NA,NA
2021-03-06,Marquette,Georgetown,Away,W,13,20,NA,13,8,21,36,26,37,15,9,20,12,32,56,33,51,18,8,60M 0S,20,13,60M 0S,13,13,NA,NA,NA,NA
2021-03-13,Marquette,Providence,Home,W,8,12,NA,8,5,13,44,22,25,11,10,12,8,20,47,28,29,16,2,60M 0S,12,16,60M 0S,8,14,NA,NA,NA,NA
2021-03-17,Marquette,Notre Dame,Away,L,3,10,NA,3,1,4,38,21,25,14,7,10,8,18,48,24,34,15,8,60M 0S,10,14,60M 0S,3,18,NA,NA,NA,NA
2021-03-27,Marquette,Cleveland St.,Home,L,10,5,NA,10,7,17,33,17,22,11,10,5,2,7,35,14,24,21,4,60M 0S,5,9,60M 0S,10,7,NA,NA,NA,NA
2021-04-03,Marquette,Denver,Away,L,6,16,NA,6,3,9,37,14,26,16,8,16,9,25,45,32,32,13,8,60M 0S,16,16,60M 0S,6,8,NA,NA,NA,NA
2021-04-10,Marquette,Georgetown,Home,W,8,10,NA,8,3,11,29,17,21,18,5,10,10,20,43,20,28,16,9,60M 0S,10,10,60M 0S,8,9,NA,NA,NA,NA
2021-04-14,Marquette,St. John's (NY),Home,W,9,8,1,9,6,15,54,28,36,17,9,8,6,14,34,20,24,20,5,61M 34S,8,12,61M 34S,9,19,NA,NA,NA,NA
2021-04-17,Marquette,Providence,Away,L,7,6,4,7,4,11,45,22,24,22,5,6,3,9,47,24,31,20,12,75M 57S,6,18,75M 57S,7,15,NA,NA,NA,NA
2021-04-24,Marquette,Villanova,Away,L,8,19,NA,8,4,12,37,18,27,17,4,19,13,32,41,27,27,12,11,60M 0S,19,8,60M 0S,8,10,NA,NA,NA,NA
2021-04-30,Marquette,St. John's (NY),Away,L,15,14,NA,15,6,21,42,28,32,12,8,14,9,23,49,31,32,18,6,60M 0S,14,17,60M 0S,15,13,NA,NA,NA,NA
2021-02-20,Maryland,Michigan,Home,L,20,9,NA,20,11,31,48,30,42,12,8,9,4,13,32,15,25,19,2,60M 0S,9,6,60M 0S,20,10,NA,NA,NA,NA
2021-02-26,Maryland,Penn St.,Away,W,13,7,NA,13,11,24,33,24,34,15,14,7,3,10,37,23,40,23,7,60M 0S,7,16,60M 0S,13,11,NA,NA,NA,NA
2021-03-06,Maryland,Johns Hopkins,Home,W,18,10,NA,18,13,31,41,27,31,10,10,10,7,17,33,24,20,15,4,60M 0S,10,14,60M 0S,18,9,NA,NA,NA,NA
2021-03-13,Maryland,Rutgers,Home,W,19,12,NA,19,10,29,45,26,30,9,8,12,8,20,39,21,28,11,3,60M 0S,12,9,60M 0S,19,7,NA,NA,NA,NA
2021-03-20,Maryland,Ohio St.,Away,W,16,8,NA,16,12,28,41,30,29,12,4,8,4,12,35,19,31,18,8,60M 0S,8,11,60M 0S,16,14,NA,NA,NA,NA
2021-03-28,Maryland,Rutgers,Away,W,13,9,NA,13,7,20,40,23,31,19,7,9,1,10,34,16,24,18,10,60M 0S,9,7,60M 0S,13,10,NA,NA,NA,NA
2021-04-03,Maryland,Penn St.,Home,W,17,10,NA,17,9,26,42,25,36,13,8,10,6,16,38,25,26,18,5,60M 0S,10,15,60M 0S,17,8,NA,NA,NA,NA
2021-04-10,Maryland,Michigan,Away,L,18,12,NA,18,13,31,41,27,25,8,4,12,9,21,32,25,26,10,4,60M 0S,12,13,60M 0S,18,9,NA,NA,NA,NA
2021-04-18,Maryland,Ohio St.,Home,L,18,8,NA,18,12,30,42,25,34,14,11,8,4,12,36,21,35,15,6,60M 0S,8,13,60M 0S,18,7,NA,NA,NA,NA
2021-04-24,Maryland,Johns Hopkins,Away,L,14,13,NA,14,6,20,39,25,33,12,5,13,8,21,38,23,30,13,6,60M 0S,13,10,60M 0S,14,11,NA,NA,NA,NA
2021-05-06,Maryland,"Michigan University Park, Pa.",Away,W,16,8,NA,16,11,27,46,27,31,9,5,8,3,11,32,19,25,10,1,60M 0S,8,11,60M 0S,16,11,NA,NA,NA,NA
2021-05-08,Maryland,"Johns Hopkins University Park, Pa.",Away,L,12,10,NA,12,7,19,33,15,25,16,7,10,4,14,33,17,37,18,9,60M 0S,10,7,60M 0S,12,3,NA,NA,NA,NA
2021-05-16,Maryland,Vermont,Home,W,17,11,NA,17,6,23,40,29,44,13,12,11,7,18,30,18,31,22,6,60M 0S,11,7,60M 0S,17,12,NA,NA,NA,NA
2021-05-22,Maryland,Notre Dame,Away,L,14,13,1,14,7,21,42,30,30,10,11,13,7,20,40,23,36,18,5,60M 39S,13,10,60M 39S,14,16,NA,NA,NA,NA
2021-05-29,Maryland,"Duke East Hartford, Conn.",Away,W,14,5,NA,14,9,23,32,25,40,23,6,5,3,8,32,22,29,16,10,60M 0S,5,17,60M 0S,14,11,NA,NA,NA,NA
2021-05-31,Maryland,"Virginia East Hartford, Conn.",Away,W,16,17,NA,16,12,28,49,28,41,10,10,17,8,25,39,28,37,14,6,60M 0S,17,11,60M 0S,16,12,NA,NA,NA,NA
2021-03-14,Massachusetts,Fairfield,Home,L,13,9,NA,13,8,21,39,25,30,15,12,9,3,12,30,19,30,21,9,60M 0S,9,10,60M 0S,13,12,NA,NA,NA,NA
2021-03-20,Massachusetts,Drexel,Home,L,13,7,NA,13,10,23,37,26,39,19,9,7,5,12,50,28,32,17,8,60M 0S,7,21,60M 0S,13,13,NA,NA,NA,NA
2021-03-23,Massachusetts,UAlbany,Away,W,12,13,NA,12,8,20,45,28,37,11,5,13,10,23,41,23,42,18,4,60M 0S,13,10,60M 0S,12,16,NA,NA,NA,NA
2021-03-30,Massachusetts,Hofstra,Away,L,16,10,NA,16,12,28,34,23,36,20,6,10,5,15,37,23,28,15,6,60M 0S,10,13,60M 0S,16,7,NA,NA,NA,NA
2021-04-03,Massachusetts,Drexel,Away,W,11,12,NA,11,5,16,36,19,26,21,3,12,7,19,38,21,28,14,6,60M 0S,12,9,60M 0S,11,8,NA,NA,NA,NA
2021-04-09,Massachusetts,Hofstra,Home,L,11,12,NA,11,6,17,31,18,28,19,10,12,8,20,36,25,37,18,7,60M 0S,12,13,60M 0S,11,7,NA,NA,NA,NA
2021-04-17,Massachusetts,Towson,Home,L,6,9,NA,6,3,9,31,19,35,21,12,9,5,14,34,19,25,20,6,60M 0S,9,10,60M 0S,6,13,NA,NA,NA,NA
2021-04-24,Massachusetts,Fairfield,Away,L,21,14,NA,21,15,36,45,33,42,17,8,14,10,24,43,21,24,15,8,60M 0S,14,7,60M 0S,21,12,NA,NA,NA,NA
2021-04-30,Massachusetts,Delaware,Away,W,6,9,NA,6,3,9,32,19,29,17,8,9,3,12,43,23,37,18,11,60M 0S,9,14,60M 0S,6,13,NA,NA,NA,NA
2021-05-06,Massachusetts,"Drexel Hempstead, NY",Away,L,8,13,NA,8,3,11,31,18,21,22,5,13,8,21,48,31,34,13,11,60M 0S,13,18,60M 0S,8,10,NA,NA,NA,NA
2021-01-30,Mercer,Bellarmine,Home,L,7,9,NA,7,4,11,31,17,40,31,14,9,3,12,29,15,20,22,17,60M 0S,9,6,60M 0S,7,10,NA,NA,NA,NA
2021-02-06,Mercer,Lenoir-Rhyne,Home,L,17,4,NA,17,7,24,57,31,33,17,10,4,1,5,19,10,18,21,7,60M 0S,4,6,60M 0S,17,14,NA,NA,NA,NA
2021-02-13,Mercer,Duke,Away,L,8,17,NA,8,3,11,29,14,31,27,8,17,10,27,35,27,36,21,12,60M 0S,17,10,60M 0S,8,6,NA,NA,NA,NA
2021-02-20,Mercer,"Jacksonville Savannah, Ga.",Away,W,11,12,1,11,6,17,42,23,32,20,3,12,10,22,42,29,24,15,9,62M 38S,12,17,62M 38S,11,12,NA,NA,NA,NA
2021-02-28,Mercer,Cleveland St.,Home,L,10,9,NA,10,5,15,42,27,24,21,9,9,5,14,28,19,26,22,10,60M 0S,9,10,60M 0S,10,17,NA,NA,NA,NA
2021-03-06,Mercer,North Carolina,Away,L,8,16,NA,8,3,11,39,19,29,19,6,16,8,24,45,33,30,15,12,60M 0S,16,17,60M 0S,8,11,NA,NA,NA,NA
2021-03-21,Mercer,Jacksonville,Home,W,6,16,NA,6,4,10,34,17,22,24,21,16,9,25,45,35,27,27,10,60M 0S,16,19,60M 0S,6,11,NA,NA,NA,NA
2021-03-27,Mercer,Utah,Home,W,15,10,NA,15,10,25,47,25,45,16,8,10,6,16,47,27,24,12,4,60M 0S,10,17,60M 0S,15,10,NA,NA,NA,NA
2021-04-03,Mercer,Air Force,Away,L,15,13,NA,15,10,25,34,24,23,12,3,13,6,19,51,27,24,8,7,60M 0S,13,14,60M 0S,15,9,NA,NA,NA,NA
2021-04-17,Mercer,High Point,Away,W,10,16,NA,10,9,19,34,23,27,19,6,16,8,24,48,28,27,15,10,60M 0S,16,12,60M 0S,10,13,NA,NA,NA,NA
2021-04-24,Mercer,VMI,Home,L,17,9,NA,17,9,26,43,28,42,21,5,9,6,15,40,20,27,12,5,60M 0S,9,11,60M 0S,17,11,NA,NA,NA,NA
2021-04-25,Mercer,Richmond,Home,W,8,21,NA,8,6,14,26,16,23,16,12,21,14,35,55,36,36,17,9,60M 0S,21,15,60M 0S,8,8,NA,NA,NA,NA
2021-05-01,Mercer,Bellarmine,Away,L,8,11,NA,8,7,15,35,21,29,24,7,11,7,18,31,21,10,13,7,60M 0S,11,10,60M 0S,8,13,NA,NA,NA,NA
2021-02-20,Merrimack,Boston U.,Home,L,12,15,NA,12,6,18,56,29,40,13,8,15,8,23,35,16,30,21,7,60M 0S,15,1,60M 0S,12,17,NA,NA,NA,NA
2021-02-27,Merrimack,UMass Lowell,Away,W,16,8,NA,16,10,26,45,30,40,22,12,8,3,11,37,19,33,26,11,60M 0S,8,11,60M 0S,16,14,NA,NA,NA,NA
2021-03-06,Merrimack,Bryant,Away,L,8,20,NA,8,7,15,23,17,26,16,11,20,10,30,61,41,31,13,9,60M 0S,20,21,60M 0S,8,9,NA,NA,NA,NA
2021-03-13,Merrimack,Wagner,Home,L,11,5,NA,11,6,17,51,32,43,13,17,5,4,9,20,8,23,29,5,60M 0S,5,3,60M 0S,11,21,NA,NA,NA,NA
2021-03-20,Merrimack,Saint Joseph's,Away,W,7,9,NA,7,3,10,28,15,28,19,8,9,6,15,42,22,35,19,13,60M 0S,9,13,60M 0S,7,8,NA,NA,NA,NA
2021-03-27,Merrimack,Bryant,Home,L,10,11,NA,10,2,12,32,23,30,21,8,11,6,17,33,22,28,20,8,60M 0S,11,11,60M 0S,10,13,NA,NA,NA,NA
2021-04-03,Merrimack,LIU,Home,W,14,10,NA,14,4,18,39,26,27,20,10,10,7,17,35,24,33,18,11,60M 0S,10,14,60M 0S,14,12,NA,NA,NA,NA
2021-04-10,Merrimack,Mount St. Mary's,Away,L,12,11,NA,12,7,19,32,23,30,17,4,11,7,18,43,23,26,10,12,60M 0S,11,12,60M 0S,12,11,NA,NA,NA,NA
2021-04-17,Merrimack,Sacred Heart,Home,W,14,10,NA,14,8,22,43,24,31,15,7,10,2,12,30,19,23,15,6,60M 0S,10,9,60M 0S,14,10,NA,NA,NA,NA
2021-04-24,Merrimack,Hobart,Away,W,10,14,NA,10,5,15,37,20,18,16,6,14,10,24,50,28,34,14,10,60M 0S,14,14,60M 0S,10,10,NA,NA,NA,NA
2021-02-20,Michigan,Maryland,Away,L,9,20,NA,9,4,13,32,15,25,19,2,20,11,31,48,30,42,12,8,60M 0S,20,10,60M 0S,9,6,NA,NA,NA,NA
2021-02-27,Michigan,Johns Hopkins,Home,W,7,14,NA,7,4,11,34,13,31,21,7,14,10,24,33,21,28,15,8,60M 0S,14,7,60M 0S,7,6,NA,NA,NA,NA
2021-03-06,Michigan,Rutgers,Away,W,12,22,NA,12,7,19,44,32,30,17,3,22,16,38,43,32,26,11,8,60M 0S,22,10,60M 0S,12,20,NA,NA,NA,NA
2021-03-14,Michigan,Ohio St.,Away,W,10,13,NA,10,3,13,39,19,34,18,6,13,8,21,40,24,29,14,8,60M 0S,13,11,60M 0S,10,9,NA,NA,NA,NA
2021-03-20,Michigan,Penn St.,Home,W,14,12,NA,14,3,17,41,25,31,10,7,12,5,17,41,29,25,10,5,60M 0S,12,17,60M 0S,14,11,NA,NA,NA,NA
2021-03-27,Michigan,Ohio St.,Home,W,6,14,NA,6,4,10,32,13,24,11,8,14,4,18,46,26,26,10,4,60M 0S,14,12,60M 0S,6,7,NA,NA,NA,NA
2021-04-04,Michigan,Johns Hopkins,Away,L,13,10,NA,13,6,19,34,21,27,20,6,10,8,18,38,26,35,16,9,60M 0S,10,16,60M 0S,13,8,NA,NA,NA,NA
2021-04-10,Michigan,Maryland,Home,L,12,18,NA,12,9,21,32,25,26,10,4,18,13,31,41,27,25,8,4,60M 0S,18,9,60M 0S,12,13,NA,NA,NA,NA
2021-04-16,Michigan,Penn St.,Away,W,13,14,1,13,9,22,45,25,29,13,11,14,11,25,35,21,32,18,2,63M 57S,14,7,63M 57S,13,12,NA,NA,NA,NA
2021-04-25,Michigan,Rutgers,Home,L,12,13,NA,12,8,20,49,31,39,10,7,13,10,23,37,23,29,12,7,60M 0S,13,10,60M 0S,12,19,NA,NA,NA,NA
2021-05-01,Michigan,Ohio St.,Away,L,15,11,NA,15,5,20,43,25,32,17,6,11,7,18,44,24,29,13,4,60M 0S,11,13,60M 0S,15,10,NA,NA,NA,NA
2021-05-06,Michigan,"Maryland University Park, Pa.",Away,L,8,16,NA,8,3,11,32,19,25,10,1,16,11,27,46,27,31,9,5,60M 0S,16,11,60M 0S,8,11,NA,NA,NA,NA
2021-03-06,Monmouth,Manhattan,Home,W,8,5,NA,8,6,14,34,23,27,18,10,5,2,7,25,14,24,20,8,60M 0S,5,9,60M 0S,8,15,NA,NA,NA,NA
2021-03-13,Monmouth,Siena,Away,L,7,6,2,7,4,11,51,33,49,18,10,6,4,10,31,18,32,26,6,68M 0S,6,12,68M 0S,7,26,NA,NA,NA,NA
2021-03-20,Monmouth,St. Bonaventure,Home,W,13,12,NA,13,7,20,42,25,44,15,7,12,6,18,26,19,16,15,5,60M 0S,12,7,60M 0S,13,12,NA,NA,NA,NA
2021-03-26,Monmouth,Manhattan,Away,W,8,9,2,8,5,13,37,19,34,23,7,9,6,15,37,19,14,13,9,67M 42S,9,10,67M 42S,8,11,NA,NA,NA,NA
2021-04-03,Monmouth,Quinnipiac,Home,L,10,8,NA,10,4,14,43,27,31,12,8,8,3,11,31,15,29,20,5,60M 0S,8,7,60M 0S,10,17,NA,NA,NA,NA
2021-04-09,Monmouth,Detroit Mercy,Home,W,9,7,NA,9,4,13,26,20,26,19,7,7,4,11,32,21,36,17,11,60M 0S,7,14,60M 0S,9,11,NA,NA,NA,NA
2021-04-23,Monmouth,Canisius,Away,W,7,8,NA,7,1,8,41,20,35,21,7,8,6,14,33,19,23,17,8,60M 0S,8,11,60M 0S,7,13,NA,NA,NA,NA
2021-04-30,Monmouth,Siena,Home,W,12,11,NA,12,5,17,46,34,39,14,10,11,6,17,32,23,22,15,8,60M 0S,11,12,60M 0S,12,22,NA,NA,NA,NA
2021-05-05,Monmouth,St. Bonaventure,Home,L,12,5,NA,12,8,20,39,25,35,16,11,5,4,9,24,14,23,15,10,60M 0S,5,9,60M 0S,12,13,NA,NA,NA,NA
2021-05-08,Monmouth,Manhattan,Away,W,14,9,NA,14,3,17,32,20,33,21,7,9,6,15,28,19,17,12,7,60M 0S,9,10,60M 0S,14,6,NA,NA,NA,NA
2021-05-15,Monmouth,North Carolina,Away,L,4,16,NA,4,1,5,35,24,29,14,6,16,11,27,43,29,36,15,9,60M 0S,16,13,60M 0S,4,20,NA,NA,NA,NA
2021-02-17,Mount St. Mary's,Delaware,Home,L,10,7,NA,10,4,14,39,27,34,12,10,7,3,10,25,17,18,17,5,60M 0S,7,10,60M 0S,10,17,NA,NA,NA,NA
2021-02-20,Mount St. Mary's,Navy,Away,W,5,8,NA,5,4,9,27,17,31,21,7,8,3,11,32,16,27,23,8,60M 0S,8,8,60M 0S,5,12,NA,NA,NA,NA
2021-02-24,Mount St. Mary's,Towson,Home,W,5,11,NA,5,0,5,33,23,33,19,13,11,6,17,23,14,13,26,7,60M 0S,11,3,60M 0S,5,18,NA,NA,NA,NA
2021-02-27,Mount St. Mary's,UMBC,Away,W,7,8,1,7,2,9,27,15,19,22,2,8,4,12,31,18,18,17,7,64M 0S,8,10,64M 0S,7,8,NA,NA,NA,NA
2021-03-02,Mount St. Mary's,Georgetown,Home,W,5,17,NA,5,3,8,19,12,20,27,6,17,14,31,45,23,36,21,16,60M 0S,17,6,60M 0S,5,7,NA,NA,NA,NA
2021-03-06,Mount St. Mary's,Hobart,Away,L,9,13,NA,9,5,14,50,25,23,11,8,13,5,18,53,29,32,15,6,60M 0S,13,16,60M 0S,9,16,NA,NA,NA,NA
2021-03-20,Mount St. Mary's,Hobart,Home,W,9,13,NA,9,4,13,40,22,39,13,7,13,5,18,42,24,33,19,4,60M 0S,13,11,60M 0S,9,13,NA,NA,NA,NA
2021-03-27,Mount St. Mary's,Saint Joseph's,Away,W,13,14,1,13,9,22,35,22,22,15,9,14,8,22,55,31,41,15,6,60M 55S,14,17,60M 55S,13,9,NA,NA,NA,NA
2021-04-07,Mount St. Mary's,VMI,Away,W,16,9,NA,16,9,25,42,25,38,17,7,9,7,16,42,23,24,11,7,60M 0S,9,14,60M 0S,16,9,NA,NA,NA,NA
2021-04-10,Mount St. Mary's,Merrimack,Home,L,11,12,NA,11,7,18,43,23,26,10,12,12,7,19,32,23,30,17,4,60M 0S,12,11,60M 0S,11,12,NA,NA,NA,NA
2021-04-14,Mount St. Mary's,Sacred Heart,Home,W,14,12,NA,14,6,20,40,27,30,16,13,12,7,19,51,33,37,18,5,60M 0S,12,21,60M 0S,14,13,NA,NA,NA,NA
2021-04-17,Mount St. Mary's,LIU,Away,W,15,17,NA,15,10,25,40,31,37,14,11,17,10,27,42,26,36,17,5,58M 51S,17,9,58M 51S,15,16,NA,NA,NA,NA
2021-05-07,Mount St. Mary's,Wagner,Home,L,20,6,NA,20,14,34,53,38,48,12,13,6,3,9,34,19,28,22,3,60M 0S,6,13,60M 0S,20,18,NA,NA,NA,NA
2021-02-20,NJIT,Delaware,Home,W,4,15,NA,4,2,6,45,13,24,11,7,15,8,23,53,35,35,15,9,60M 0S,15,20,60M 0S,4,9,NA,NA,NA,NA
2021-02-27,NJIT,Lehigh,Away,W,10,24,NA,10,5,15,34,20,29,13,5,24,15,39,54,38,44,8,8,60M 0S,24,14,60M 0S,10,10,NA,NA,NA,NA
2021-03-06,NJIT,Binghamton,Home,W,5,11,NA,5,3,8,30,10,30,28,9,11,7,18,32,24,38,22,12,60M 0S,11,13,60M 0S,5,5,NA,NA,NA,NA
2021-03-14,NJIT,Stony Brook,Away,L,4,13,NA,4,3,7,22,11,20,24,5,13,10,23,53,32,38,13,9,60M 0S,13,19,60M 0S,4,7,NA,NA,NA,NA
2021-03-20,NJIT,Vermont,Home,W,2,17,NA,2,1,3,25,15,17,13,7,17,14,31,76,39,34,15,4,60M 0S,17,22,60M 0S,2,13,NA,NA,NA,NA
2021-03-27,NJIT,UMass Lowell,Away,L,14,10,NA,14,7,21,34,22,29,18,5,10,6,16,47,21,33,13,5,60M 0S,10,11,60M 0S,14,8,NA,NA,NA,NA
2021-04-03,NJIT,Binghamton,Away,L,9,11,NA,9,7,16,26,22,26,19,12,11,5,16,37,26,35,19,12,60M 0S,11,15,60M 0S,9,13,NA,NA,NA,NA
2021-04-10,NJIT,Stony Brook,Home,W,8,12,NA,8,5,13,24,15,31,25,4,12,8,20,45,30,28,14,12,60M 0S,12,18,60M 0S,8,7,NA,NA,NA,NA
2021-04-17,NJIT,Hartford,Away,L,9,14,NA,9,3,12,40,20,28,20,4,14,10,24,43,29,30,13,10,60M 0S,14,15,60M 0S,9,11,NA,NA,NA,NA
2021-04-24,NJIT,UAlbany,Away,L,8,18,NA,8,3,11,34,16,36,22,6,18,14,32,47,32,43,16,8,60M 0S,18,14,60M 0S,8,8,NA,NA,NA,NA
2021-05-01,NJIT,UMBC,Home,W,6,14,NA,6,4,10,42,24,26,13,9,14,3,17,44,26,34,12,3,60M 0S,14,12,60M 0S,6,18,NA,NA,NA,NA
2021-02-20,Navy,Mount St. Mary's,Home,W,8,5,NA,8,3,11,32,16,27,23,8,5,4,9,27,17,31,21,7,60M 0S,5,12,60M 0S,8,8,NA,NA,NA,NA
2021-02-28,Navy,Jacksonville,Home,L,13,6,NA,13,5,18,31,21,43,14,9,6,5,11,29,15,28,20,11,60M 0S,6,9,60M 0S,13,8,NA,NA,NA,NA
2021-03-28,Navy,Bucknell,Home,W,13,10,NA,13,11,24,35,23,42,15,11,10,5,15,47,27,38,18,6,60M 0S,10,17,60M 0S,13,10,NA,NA,NA,NA
2021-04-03,Navy,Loyola Maryland,Home,L,10,14,NA,10,7,17,40,22,36,12,8,14,9,23,40,27,40,20,5,60M 0S,14,13,60M 0S,10,12,NA,NA,NA,NA
2021-04-10,Navy,Lehigh,Away,L,7,13,NA,7,4,11,36,21,25,10,2,13,11,24,55,28,42,11,4,60M 0S,13,15,60M 0S,7,14,NA,NA,NA,NA
2021-04-17,Navy,Loyola Maryland,Away,L,14,12,NA,14,10,24,42,27,39,18,9,12,6,18,42,27,45,15,9,60M 0S,12,15,60M 0S,14,13,NA,NA,NA,NA
2021-04-24,Navy,Army West Point,Home,W,9,4,NA,9,5,14,39,19,38,18,8,4,2,6,41,23,27,16,10,60M 0S,4,19,60M 0S,9,10,NA,NA,NA,NA
2021-05-01,Navy,Lafayette,Away,L,14,10,NA,14,6,20,34,22,37,14,4,10,2,12,41,24,24,10,5,60M 0S,10,14,60M 0S,14,8,NA,NA,NA,NA
2021-05-04,Navy,Loyola Maryland,Away,L,9,16,NA,9,6,15,30,18,25,14,3,16,9,25,46,30,40,12,8,60M 0S,16,14,60M 0S,9,9,NA,NA,NA,NA
2021-02-07,North Carolina,Denver,Home,W,24,13,NA,24,15,39,53,34,33,9,11,13,4,17,42,26,30,15,0,60M 0S,13,13,60M 0S,24,10,NA,NA,NA,NA
2021-02-13,North Carolina,Jacksonville,Home,L,18,7,NA,18,7,25,53,30,34,12,7,7,4,11,24,14,23,18,5,60M 0S,7,7,60M 0S,18,12,NA,NA,NA,NA
2021-02-16,North Carolina,High Point,Home,W,17,15,NA,17,12,29,67,35,45,17,6,15,7,22,35,25,34,12,7,60M 0S,15,10,60M 0S,17,18,NA,NA,NA,NA
2021-02-21,North Carolina,Richmond,Away,W,14,9,NA,14,7,21,46,33,30,13,6,9,5,14,33,18,24,17,10,60M 0S,9,9,60M 0S,14,19,NA,NA,NA,NA
2021-02-27,North Carolina,High Point,Home,W,27,12,NA,27,11,38,54,36,44,14,11,12,7,19,34,20,15,17,6,60M 0S,12,8,60M 0S,27,9,NA,NA,NA,NA
2021-03-06,North Carolina,Mercer,Home,L,16,8,NA,16,8,24,45,33,30,15,12,8,3,11,39,19,29,19,6,60M 0S,8,11,60M 0S,16,17,NA,NA,NA,NA
2021-03-11,North Carolina,Virginia,Away,L,16,13,NA,16,12,28,48,31,24,8,4,13,8,21,62,33,37,11,3,60M 0S,13,20,60M 0S,16,15,NA,NA,NA,NA
2021-03-20,North Carolina,Air Force,Home,L,15,5,NA,15,10,25,51,28,35,11,5,5,2,7,34,15,25,15,6,60M 0S,5,10,60M 0S,15,13,NA,NA,NA,NA
2021-04-01,North Carolina,Duke,Away,W,11,12,1,11,6,17,46,28,34,13,9,12,6,18,51,26,38,16,6,63M 13S,12,14,63M 13S,11,17,NA,NA,NA,NA
2021-04-10,North Carolina,Virginia,Home,L,16,18,NA,16,6,22,51,31,37,10,8,18,13,31,44,33,36,15,3,60M 0S,18,15,60M 0S,16,15,NA,NA,NA,NA
2021-04-17,North Carolina,Syracuse,Away,W,21,9,NA,21,13,34,58,37,42,12,7,9,6,15,38,22,33,14,7,60M 0S,9,13,60M 0S,21,16,NA,NA,NA,NA
2021-04-25,North Carolina,Notre Dame,Home,W,12,10,NA,12,5,17,45,25,38,14,4,10,6,16,42,23,33,14,5,60M 0S,10,13,60M 0S,12,13,NA,NA,NA,NA
2021-05-02,North Carolina,Duke,Home,W,15,12,NA,15,5,20,50,27,37,11,6,12,8,20,39,23,22,13,4,60M 0S,12,11,60M 0S,15,12,NA,NA,NA,NA
2021-05-15,North Carolina,Monmouth,Home,L,16,4,NA,16,11,27,43,29,36,15,9,4,1,5,35,24,29,14,6,60M 0S,4,20,60M 0S,16,13,NA,NA,NA,NA
2021-05-22,North Carolina,"Rutgers Hempstead, NY",Away,L,12,11,1,12,6,18,41,28,28,14,13,11,3,14,38,21,27,16,6,64M 0S,11,10,64M 0S,12,16,NA,NA,NA,NA
2021-05-29,North Carolina,"Virginia East Hartford, Conn.",Away,W,11,12,NA,11,4,15,49,26,38,12,15,12,5,17,39,17,43,22,7,60M 0S,12,5,60M 0S,11,15,NA,NA,NA,NA
2021-02-27,Notre Dame,Robert Morris,Home,L,19,7,NA,19,17,36,57,33,43,17,8,7,4,11,31,21,22,17,9,60M 0S,7,14,60M 0S,19,14,NA,NA,NA,NA
2021-03-06,Notre Dame,Bellarmine,Home,L,12,6,NA,12,9,21,41,27,37,17,8,6,3,9,20,14,13,18,7,60M 0S,6,8,60M 0S,12,15,NA,NA,NA,NA
2021-03-17,Notre Dame,Marquette,Home,L,10,3,NA,10,8,18,48,24,34,15,8,3,1,4,38,21,25,14,7,60M 0S,3,18,60M 0S,10,14,NA,NA,NA,NA
2021-03-20,Notre Dame,Cleveland St.,Home,L,19,5,NA,19,11,30,57,32,41,11,8,5,4,9,30,16,24,12,5,60M 0S,5,11,60M 0S,19,13,NA,NA,NA,NA
2021-03-27,Notre Dame,Virginia,Home,L,11,12,NA,11,7,18,42,20,30,10,8,12,9,21,30,19,21,14,2,60M 0S,12,7,60M 0S,11,9,NA,NA,NA,NA
2021-04-03,Notre Dame,Syracuse,Away,L,18,11,NA,18,10,28,47,29,45,16,5,11,3,14,34,21,20,12,8,60M 0S,11,10,60M 0S,18,11,NA,NA,NA,NA
2021-04-10,Notre Dame,Duke,Home,L,13,8,NA,13,6,19,44,24,22,12,9,8,6,14,36,20,25,22,3,60M 0S,8,12,60M 0S,13,11,NA,NA,NA,NA
2021-04-22,Notre Dame,Duke,Away,W,12,13,1,12,6,18,40,22,27,17,5,13,4,17,41,27,29,15,6,61M 55S,13,14,61M 55S,12,10,NA,NA,NA,NA
2021-04-25,Notre Dame,North Carolina,Away,W,10,12,NA,10,6,16,42,23,33,14,5,12,5,17,45,25,38,14,4,60M 0S,12,13,60M 0S,10,13,NA,NA,NA,NA
2021-05-01,Notre Dame,Syracuse,Home,L,22,8,NA,22,13,35,63,31,42,15,10,8,5,13,43,22,30,16,9,60M 0S,8,14,60M 0S,22,9,NA,NA,NA,NA
2021-05-15,Notre Dame,"Drexel Denver, Colo.",Away,W,10,8,NA,10,3,13,47,25,37,16,4,8,2,10,42,25,34,15,9,60M 0S,8,17,60M 0S,10,15,NA,NA,NA,NA
2021-05-22,Notre Dame,Maryland,Home,L,13,14,1,13,7,20,40,23,36,18,5,14,7,21,42,30,30,10,11,60M 39S,14,16,60M 39S,13,10,NA,NA,NA,NA
2021-02-20,Ohio St.,Johns Hopkins,Away,W,14,8,NA,14,3,17,37,27,33,16,5,8,3,11,32,19,26,19,5,60M 0S,8,11,60M 0S,14,13,NA,NA,NA,NA
2021-02-27,Ohio St.,Rutgers,Home,L,12,22,NA,12,8,20,31,23,28,19,6,22,11,33,58,33,38,13,11,60M 0S,22,11,60M 0S,12,11,NA,NA,NA,NA
2021-03-06,Ohio St.,Penn St.,Away,W,13,15,NA,13,8,21,35,16,31,24,8,15,7,22,43,20,36,18,10,60M 0S,15,5,60M 0S,13,3,NA,NA,NA,NA
2021-03-14,Ohio St.,Michigan,Home,W,13,10,NA,13,8,21,40,24,29,14,8,10,3,13,39,19,34,18,6,60M 0S,10,9,60M 0S,13,11,NA,NA,NA,NA
2021-03-20,Ohio St.,Maryland,Home,W,8,16,NA,8,4,12,35,19,31,18,8,16,12,28,41,30,29,12,4,60M 0S,16,14,60M 0S,8,11,NA,NA,NA,NA
2021-03-27,Ohio St.,Michigan,Away,W,14,6,NA,14,4,18,46,26,26,10,4,6,4,10,32,13,24,11,8,60M 0S,6,7,60M 0S,14,12,NA,NA,NA,NA
2021-04-03,Ohio St.,Rutgers,Away,L,9,10,NA,9,3,12,44,24,27,12,5,10,5,15,38,21,20,9,6,60M 0S,10,11,60M 0S,9,15,NA,NA,NA,NA
2021-04-10,Ohio St.,Johns Hopkins,Home,W,14,12,NA,14,9,23,39,22,30,14,6,12,5,17,37,19,31,15,4,60M 0S,12,7,60M 0S,14,8,NA,NA,NA,NA
2021-04-18,Ohio St.,Maryland,Away,L,8,18,NA,8,4,12,36,21,35,15,6,18,12,30,42,25,34,14,11,60M 0S,18,7,60M 0S,8,13,NA,NA,NA,NA
2021-04-24,Ohio St.,Penn St.,Home,W,9,10,NA,9,4,13,35,24,28,14,6,10,4,14,43,22,32,15,6,60M 0S,10,12,60M 0S,9,15,NA,NA,NA,NA
2021-05-01,Ohio St.,Michigan,Home,L,11,15,NA,11,7,18,44,24,29,13,4,15,5,20,43,25,32,17,6,60M 0S,15,10,60M 0S,11,13,NA,NA,NA,NA
2021-02-20,Penn St.,Rutgers,Away,L,9,11,NA,9,5,14,39,24,29,12,2,11,6,17,40,19,31,12,8,60M 0S,11,8,60M 0S,9,15,NA,NA,NA,NA
2021-02-26,Penn St.,Maryland,Home,W,7,13,NA,7,3,10,37,23,40,23,7,13,11,24,33,24,34,15,14,60M 0S,13,11,60M 0S,7,16,NA,NA,NA,NA
2021-03-06,Penn St.,Ohio St.,Home,W,15,13,NA,15,7,22,43,20,36,18,10,13,8,21,35,16,31,24,8,60M 0S,13,3,60M 0S,15,5,NA,NA,NA,NA
2021-03-13,Penn St.,Johns Hopkins,Away,L,6,13,NA,6,2,8,22,12,25,20,5,13,6,19,46,27,28,10,9,60M 0S,13,14,60M 0S,6,6,NA,NA,NA,NA
2021-03-20,Penn St.,Michigan,Away,W,12,14,NA,12,5,17,41,29,25,10,5,14,3,17,41,25,31,10,7,60M 0S,14,11,60M 0S,12,17,NA,NA,NA,NA
2021-03-28,Penn St.,Johns Hopkins,Home,L,11,8,NA,11,8,19,39,20,35,22,7,8,4,12,39,23,39,14,11,60M 0S,8,15,60M 0S,11,9,NA,NA,NA,NA
2021-04-03,Penn St.,Maryland,Away,W,10,17,NA,10,6,16,38,25,26,18,5,17,9,26,42,25,36,13,8,60M 0S,17,8,60M 0S,10,15,NA,NA,NA,NA
2021-04-10,Penn St.,Rutgers,Home,L,10,22,NA,10,6,16,36,23,39,23,7,22,9,31,75,43,48,14,14,60M 0S,22,21,60M 0S,10,13,NA,NA,NA,NA
2021-04-16,Penn St.,Michigan,Home,W,14,13,1,14,11,25,35,21,32,18,2,13,9,22,45,25,29,13,11,63M 57S,13,12,63M 57S,14,7,NA,NA,NA,NA
2021-04-24,Penn St.,Ohio St.,Away,W,10,9,NA,10,4,14,43,22,32,15,6,9,4,13,35,24,28,14,6,60M 0S,9,15,60M 0S,10,12,NA,NA,NA,NA
2021-05-01,Penn St.,Johns Hopkins,Home,W,7,15,NA,7,5,12,36,19,28,17,5,15,9,24,31,21,28,13,10,60M 0S,15,6,60M 0S,7,12,NA,NA,NA,NA
2021-02-13,Providence,Bryant,Away,W,8,9,NA,8,5,13,43,24,32,16,7,9,8,17,37,21,34,20,8,60M 0S,9,12,60M 0S,8,16,NA,NA,NA,NA
2021-02-21,Providence,St. John's (NY),Away,W,16,8,NA,16,8,24,59,33,44,19,4,8,1,9,26,15,21,19,10,60M 0S,8,7,60M 0S,16,17,NA,NA,NA,NA
2021-02-27,Providence,Denver,Away,W,10,23,NA,10,3,13,42,21,25,16,5,23,18,41,48,31,34,11,9,60M 0S,23,8,60M 0S,10,11,NA,NA,NA,NA
2021-03-03,Providence,Fairfield,Home,W,18,17,NA,18,8,26,63,34,27,11,6,17,11,28,53,31,34,16,5,60M 0S,17,14,60M 0S,18,16,NA,NA,NA,NA
2021-03-07,Providence,Villanova,Home,W,8,11,NA,8,5,13,43,24,23,19,14,11,7,18,37,19,17,21,10,60M 0S,11,8,60M 0S,8,16,NA,NA,NA,NA
2021-03-13,Providence,Marquette,Away,W,12,8,NA,12,8,20,47,28,29,16,2,8,5,13,44,22,25,11,10,60M 0S,8,14,60M 0S,12,16,NA,NA,NA,NA
2021-03-20,Providence,Georgetown,Home,W,9,14,NA,9,2,11,41,14,23,17,5,14,7,21,47,34,33,11,8,60M 0S,14,20,60M 0S,9,5,NA,NA,NA,NA
2021-03-27,Providence,Denver,Home,L,11,19,NA,11,5,16,32,22,20,11,3,19,14,33,63,35,46,18,3,60M 0S,19,16,60M 0S,11,11,NA,NA,NA,NA
2021-04-03,Providence,Villanova,Away,L,6,13,NA,6,2,8,33,17,28,21,4,13,4,17,45,24,24,9,7,60M 0S,13,11,60M 0S,6,11,NA,NA,NA,NA
2021-04-10,Providence,St. John's (NY),Home,L,19,9,NA,19,14,33,64,38,37,9,2,9,6,15,36,24,17,9,1,60M 0S,9,15,60M 0S,19,19,NA,NA,NA,NA
2021-04-17,Providence,Marquette,Home,L,6,7,4,6,3,9,47,24,31,20,12,7,4,11,45,22,24,22,5,75M 57S,7,15,75M 57S,6,18,NA,NA,NA,NA
2021-04-24,Providence,Georgetown,Away,L,5,14,NA,5,4,9,51,30,33,14,9,14,10,24,45,29,32,15,11,60M 0S,14,15,60M 0S,5,25,NA,NA,NA,NA
2021-05-06,Providence,Denver,Home,W,5,14,NA,5,2,7,38,19,30,14,5,14,10,24,51,28,29,10,4,60M 0S,14,14,60M 0S,5,14,NA,NA,NA,NA
2021-03-06,Quinnipiac,St. Bonaventure,Home,W,6,13,NA,6,6,12,38,20,26,13,5,13,11,24,31,24,22,13,5,60M 0S,13,11,60M 0S,6,14,NA,NA,NA,NA
2021-03-27,Quinnipiac,St. Bonaventure,Away,L,5,4,NA,5,3,8,29,16,23,21,8,4,2,6,36,18,21,15,10,60M 0S,4,14,60M 0S,5,11,NA,NA,NA,NA
2021-04-03,Quinnipiac,Monmouth,Away,L,8,10,NA,8,3,11,31,15,29,20,5,10,4,14,43,27,31,12,8,60M 0S,10,17,60M 0S,8,7,NA,NA,NA,NA
2021-04-07,Quinnipiac,Siena,Home,W,7,5,NA,7,3,10,48,18,35,22,9,5,3,8,44,21,15,13,11,60M 0S,5,16,60M 0S,7,11,NA,NA,NA,NA
2021-04-10,Quinnipiac,Manhattan,Home,W,13,12,2,13,6,19,48,24,37,24,9,12,7,19,42,21,16,17,9,66M 46S,12,9,66M 46S,13,11,NA,NA,NA,NA
2021-04-17,Quinnipiac,Canisius,Home,W,16,12,NA,16,11,27,47,27,29,19,9,12,4,16,52,27,19,13,9,60M 0S,12,15,60M 0S,16,11,NA,NA,NA,NA
2021-04-20,Quinnipiac,Marist,Away,L,9,14,NA,9,3,12,50,23,39,22,9,14,6,20,46,28,22,15,10,60M 0S,14,14,60M 0S,9,14,NA,NA,NA,NA
2021-02-14,Richmond,Loyola Maryland,Home,L,7,8,1,7,3,10,32,17,26,18,12,8,5,13,36,20,28,19,11,61M 1S,8,12,61M 1S,7,10,NA,NA,NA,NA
2021-02-21,Richmond,North Carolina,Home,W,9,14,NA,9,5,14,33,18,24,17,10,14,7,21,46,33,30,13,6,60M 0S,14,19,60M 0S,9,9,NA,NA,NA,NA
2021-02-27,Richmond,Towson,Home,W,11,10,NA,11,5,16,35,16,29,20,5,10,8,18,35,23,25,14,8,60M 0S,10,13,60M 0S,11,5,NA,NA,NA,NA
2021-03-07,Richmond,Duke,Home,W,6,13,NA,6,4,10,39,21,23,11,6,13,6,19,34,21,24,15,2,60M 0S,13,8,60M 0S,6,15,NA,NA,NA,NA
2021-03-13,Richmond,VMI,Away,W,23,6,NA,23,16,39,57,42,46,17,9,6,3,9,19,13,18,22,12,60M 0S,6,7,60M 0S,23,19,NA,NA,NA,NA
2021-03-20,Richmond,Bellarmine,Away,W,17,5,NA,17,15,32,39,29,23,15,9,5,2,7,36,17,17,17,9,60M 0S,5,12,60M 0S,17,12,NA,NA,NA,NA
2021-03-26,Richmond,High Point,Home,W,17,10,NA,17,13,30,50,34,31,14,14,10,2,12,34,23,23,17,7,60M 0S,10,13,60M 0S,17,17,NA,NA,NA,NA
2021-04-03,Richmond,Virginia,Away,W,10,18,NA,10,8,18,30,20,36,22,13,18,12,30,47,28,54,21,16,60M 0S,18,10,60M 0S,10,10,NA,NA,NA,NA
2021-04-17,Richmond,Jacksonville,Home,L,14,7,NA,14,9,23,39,21,30,20,8,7,5,12,30,19,22,17,4,60M 0S,7,12,60M 0S,14,7,NA,NA,NA,NA
2021-04-25,Richmond,Mercer,Away,W,21,8,NA,21,14,35,55,36,36,17,9,8,6,14,26,16,23,16,12,60M 0S,8,8,60M 0S,21,15,NA,NA,NA,NA
2021-05-01,Richmond,Air Force,Home,L,8,9,NA,8,6,14,43,24,30,19,14,9,6,15,31,20,25,24,14,60M 0S,9,11,60M 0S,8,16,NA,NA,NA,NA
2021-05-05,Richmond,Air Force,Home,L,11,6,NA,11,6,17,38,24,31,13,13,6,4,10,40,18,26,18,6,60M 0S,6,12,60M 0S,11,13,NA,NA,NA,NA
2021-05-07,Richmond,High Point,Home,W,8,11,NA,8,4,12,30,20,23,13,16,11,4,15,28,22,26,21,3,60M 0S,11,11,60M 0S,8,12,NA,NA,NA,NA
2021-02-07,Robert Morris,Duke,Away,W,12,16,NA,12,7,19,40,26,26,18,8,16,11,27,50,31,43,14,11,60M 0S,16,15,60M 0S,12,14,NA,NA,NA,NA
2021-02-13,Robert Morris,High Point,Away,W,15,21,NA,15,9,24,41,25,25,20,13,21,10,31,48,34,35,19,17,59M 19S,21,13,59M 19S,15,10,NA,NA,NA,NA
2021-02-21,Robert Morris,Colgate,Away,L,17,14,NA,17,10,27,48,34,42,12,7,14,13,27,42,28,29,19,4,60M 0S,14,14,60M 0S,17,17,NA,NA,NA,NA
2021-02-27,Robert Morris,Notre Dame,Away,L,7,19,NA,7,4,11,31,21,22,17,9,19,17,36,57,33,43,17,8,60M 0S,19,14,60M 0S,7,14,NA,NA,NA,NA
2021-03-02,Robert Morris,Bellarmine,Home,L,17,8,NA,17,14,31,39,29,41,14,6,8,6,14,43,22,29,15,5,60M 0S,8,14,60M 0S,17,12,NA,NA,NA,NA
2021-03-13,Robert Morris,Air Force,Away,L,14,13,NA,14,11,25,35,23,41,25,12,13,9,22,50,30,49,24,10,60M 0S,13,17,60M 0S,14,9,NA,NA,NA,NA
2021-03-20,Robert Morris,Virginia,Away,W,12,14,NA,12,9,21,52,27,31,18,8,14,11,25,35,23,43,26,5,60M 0S,14,9,60M 0S,12,15,NA,NA,NA,NA
2021-03-27,Robert Morris,Drexel,Away,W,13,19,NA,13,5,18,45,27,34,18,9,19,10,29,51,33,41,20,7,60M 0S,19,14,60M 0S,13,14,NA,NA,NA,NA
2021-04-03,Robert Morris,"Jacksonville Fort Mill, S.C.",Away,L,16,15,NA,16,8,24,44,34,35,17,10,15,8,23,28,19,26,14,1,60M 0S,15,7,60M 0S,16,17,NA,NA,NA,NA
2021-04-10,Robert Morris,Cleveland St.,Home,L,15,7,NA,15,7,22,53,32,38,16,14,7,2,9,31,17,25,30,6,60M 0S,7,10,60M 0S,15,17,NA,NA,NA,NA
2021-04-16,Robert Morris,Bucknell,Away,L,8,7,NA,8,6,14,34,17,40,23,12,7,3,10,31,20,29,18,13,60M 0S,7,13,60M 0S,8,9,NA,NA,NA,NA
2021-05-01,Robert Morris,Utah,Away,L,16,12,NA,16,8,24,42,29,32,12,5,12,7,19,42,24,24,8,6,60M 0S,12,12,60M 0S,16,13,NA,NA,NA,NA
2021-05-07,Robert Morris,Syracuse,Away,W,14,21,NA,14,7,21,39,24,30,13,14,21,12,33,58,41,45,16,6,60M 0S,21,20,60M 0S,14,10,NA,NA,NA,NA
2021-02-20,Rutgers,Penn St.,Home,L,11,9,NA,11,6,17,40,19,31,12,8,9,5,14,39,24,29,12,2,60M 0S,9,15,60M 0S,11,8,NA,NA,NA,NA
2021-02-27,Rutgers,Ohio St.,Away,L,22,12,NA,22,11,33,58,33,38,13,11,12,8,20,31,23,28,19,6,60M 0S,12,11,60M 0S,22,11,NA,NA,NA,NA
2021-03-06,Rutgers,Michigan,Home,W,22,12,NA,22,16,38,43,32,26,11,8,12,7,19,44,32,30,17,3,60M 0S,12,20,60M 0S,22,10,NA,NA,NA,NA
2021-03-13,Rutgers,Maryland,Away,W,12,19,NA,12,8,20,39,21,28,11,3,19,10,29,45,26,30,9,8,60M 0S,19,7,60M 0S,12,9,NA,NA,NA,NA
2021-03-20,Rutgers,Johns Hopkins,Away,W,15,9,NA,15,12,27,46,21,26,13,7,9,5,14,31,21,27,18,6,60M 0S,9,12,60M 0S,15,6,NA,NA,NA,NA
2021-03-28,Rutgers,Maryland,Home,W,9,13,NA,9,1,10,34,16,24,18,10,13,7,20,40,23,31,19,7,60M 0S,13,10,60M 0S,9,7,NA,NA,NA,NA
2021-04-03,Rutgers,Ohio St.,Home,L,10,9,NA,10,5,15,38,21,20,9,6,9,3,12,44,24,27,12,5,60M 0S,9,15,60M 0S,10,11,NA,NA,NA,NA
2021-04-10,Rutgers,Penn St.,Away,L,22,10,NA,22,9,31,75,43,48,14,14,10,6,16,36,23,39,23,7,60M 0S,10,13,60M 0S,22,21,NA,NA,NA,NA
2021-04-17,Rutgers,Johns Hopkins,Home,W,17,11,NA,17,11,28,44,28,30,9,7,11,7,18,33,26,22,17,4,60M 0S,11,15,60M 0S,17,11,NA,NA,NA,NA
2021-04-25,Rutgers,Michigan,Away,L,13,12,NA,13,10,23,37,23,29,12,7,12,8,20,49,31,39,10,7,60M 0S,12,19,60M 0S,13,10,NA,NA,NA,NA
2021-05-06,Rutgers,"Johns Hopkins University Park, Pa.",Away,W,10,12,NA,10,4,14,42,22,26,13,5,12,4,16,36,24,34,16,5,60M 0S,12,12,60M 0S,10,12,NA,NA,NA,NA
2021-05-15,Rutgers,"Lehigh Charlottesville, Va.",Away,W,12,5,NA,12,7,19,42,29,30,12,10,5,4,9,35,22,31,14,6,60M 0S,5,17,60M 0S,12,17,NA,NA,NA,NA
2021-05-22,Rutgers,"North Carolina Hempstead, NY",Away,W,11,12,1,11,3,14,38,21,27,16,6,12,6,18,41,28,28,14,13,64M 0S,12,16,64M 0S,11,10,NA,NA,NA,NA
2021-02-13,Sacred Heart,Stony Brook,Away,L,8,20,NA,8,5,13,33,19,23,17,6,20,14,34,55,40,41,13,4,60M 0S,20,20,60M 0S,8,11,NA,NA,NA,NA
2021-02-20,Sacred Heart,Hofstra,Home,W,6,13,NA,6,3,9,32,17,19,11,5,13,7,20,44,25,30,11,7,60M 0S,13,12,60M 0S,6,11,NA,NA,NA,NA
2021-02-24,Sacred Heart,LIU,Home,W,12,10,NA,12,4,16,62,33,42,9,13,10,6,16,38,25,26,24,1,47M 33S,10,15,47M 33S,12,21,NA,NA,NA,NA
2021-02-27,Sacred Heart,Holy Cross,Away,W,10,11,NA,10,7,17,43,28,30,16,1,11,6,17,40,25,29,13,10,60M 0S,11,14,60M 0S,10,18,NA,NA,NA,NA
2021-03-06,Sacred Heart,LIU,Home,L,10,13,NA,10,5,15,44,28,23,11,4,13,9,22,39,31,35,12,3,60M 0S,13,18,60M 0S,10,18,NA,NA,NA,NA
2021-03-13,Sacred Heart,Saint Joseph's,Home,W,9,13,NA,9,5,14,42,23,15,14,5,13,5,18,42,30,31,9,5,60M 0S,13,17,60M 0S,9,14,NA,NA,NA,NA
2021-03-17,Sacred Heart,Fairfield,Away,L,8,14,NA,8,4,12,39,18,23,19,5,14,11,25,54,27,33,20,8,60M 0S,14,13,60M 0S,8,10,NA,NA,NA,NA
2021-03-20,Sacred Heart,LIU,Away,L,8,13,NA,8,6,14,43,27,28,14,4,13,7,20,51,33,40,20,4,60M 0S,13,20,60M 0S,8,19,NA,NA,NA,NA
2021-04-14,Sacred Heart,Mount St. Mary's,Away,W,12,14,NA,12,7,19,51,33,37,18,5,14,6,20,40,27,30,16,13,60M 0S,14,13,60M 0S,12,21,NA,NA,NA,NA
2021-04-17,Sacred Heart,Merrimack,Away,W,10,14,NA,10,2,12,30,19,23,15,6,14,8,22,43,24,31,15,7,60M 0S,14,10,60M 0S,10,9,NA,NA,NA,NA
2021-04-21,Sacred Heart,Wagner,Home,W,9,11,NA,9,4,13,52,29,31,14,11,11,4,15,30,18,21,23,5,60M 0S,11,7,60M 0S,9,20,NA,NA,NA,NA
2021-04-24,Sacred Heart,Bryant,Home,L,12,20,NA,12,9,21,42,24,35,16,5,20,8,28,51,30,34,13,8,48M 48S,20,10,48M 48S,12,12,NA,NA,NA,NA
2021-05-01,Sacred Heart,Hobart,Away,W,12,14,NA,12,5,17,38,20,20,14,6,14,10,24,49,28,46,19,10,60M 0S,14,14,60M 0S,12,8,NA,NA,NA,NA
2021-02-13,Saint Joseph's,Towson,Away,W,7,8,1,7,2,9,34,18,33,28,5,8,4,12,42,20,40,21,17,61M 24S,8,12,61M 24S,7,11,NA,NA,NA,NA
2021-02-23,Saint Joseph's,Delaware,Away,W,13,16,NA,13,6,19,54,29,35,17,8,16,9,25,39,22,35,13,9,60M 0S,16,6,60M 0S,13,16,NA,NA,NA,NA
2021-02-27,Saint Joseph's,Army West Point,Away,L,5,13,NA,5,2,7,37,17,27,18,9,13,5,18,42,22,29,16,8,60M 0S,13,9,60M 0S,5,12,NA,NA,NA,NA
2021-03-08,Saint Joseph's,Wagner,Away,W,17,5,NA,17,14,31,52,38,50,14,7,5,3,8,27,13,28,18,2,60M 0S,5,8,60M 0S,17,21,NA,NA,NA,NA
2021-03-13,Saint Joseph's,Sacred Heart,Away,W,13,9,NA,13,5,18,42,30,31,9,5,9,5,14,42,23,15,14,5,60M 0S,9,14,60M 0S,13,17,NA,NA,NA,NA
2021-03-20,Saint Joseph's,Merrimack,Home,W,9,7,NA,9,6,15,42,22,35,19,13,7,3,10,28,15,28,19,8,60M 0S,7,8,60M 0S,9,13,NA,NA,NA,NA
2021-03-27,Saint Joseph's,Mount St. Mary's,Home,W,14,13,1,14,8,22,55,31,41,15,6,13,9,22,35,22,22,15,9,60M 55S,13,9,60M 55S,14,17,NA,NA,NA,NA
2021-04-10,Saint Joseph's,Hobart,Away,L,13,12,1,13,9,22,50,28,27,17,7,12,4,16,44,22,32,19,9,61M 28S,12,10,61M 28S,13,15,NA,NA,NA,NA
2021-04-17,Saint Joseph's,Bryant,Away,W,13,5,NA,13,7,20,45,30,52,25,7,5,2,7,43,20,26,18,12,60M 0S,5,15,60M 0S,13,17,NA,NA,NA,NA
2021-04-24,Saint Joseph's,LIU,Home,W,14,13,NA,14,11,25,48,33,30,17,12,13,10,23,30,19,27,18,5,60M 0S,13,6,60M 0S,14,19,NA,NA,NA,NA
2021-04-30,Saint Joseph's,Wagner,Home,L,14,7,NA,14,14,28,48,31,37,13,17,7,5,12,38,20,32,22,5,60M 0S,7,13,60M 0S,14,17,NA,NA,NA,NA
2021-05-05,Saint Joseph's,LIU,Home,W,19,11,NA,19,15,34,45,32,45,13,16,11,4,15,28,16,24,21,11,60M 0S,11,5,60M 0S,19,13,NA,NA,NA,NA
2021-05-08,Saint Joseph's,Bryant,Home,L,10,16,NA,10,4,14,49,28,31,15,7,16,7,23,47,27,45,13,6,60M 0S,16,11,60M 0S,10,18,NA,NA,NA,NA
2021-03-06,Siena,Canisius,Home,L,7,8,NA,7,6,13,31,19,33,23,6,8,3,11,30,15,31,27,5,60M 0S,8,7,60M 0S,7,12,NA,NA,NA,NA
2021-03-13,Siena,Monmouth,Home,L,6,7,2,6,4,10,31,18,32,26,6,7,4,11,51,33,49,18,10,68M 0S,7,26,68M 0S,6,12,NA,NA,NA,NA
2021-03-20,Siena,Canisius,Home,L,10,12,NA,10,6,16,50,22,36,13,18,12,9,21,30,25,34,26,5,60M 0S,12,13,60M 0S,10,12,NA,NA,NA,NA
2021-03-27,Siena,Detroit Mercy,Away,L,9,11,NA,9,6,15,31,22,21,19,8,11,5,16,49,23,43,21,11,60M 0S,11,12,60M 0S,9,13,NA,NA,NA,NA
2021-04-07,Siena,Quinnipiac,Away,W,5,7,NA,5,3,8,44,21,15,13,11,7,3,10,48,18,35,22,9,60M 0S,7,11,60M 0S,5,16,NA,NA,NA,NA
2021-04-17,Siena,Manhattan,Away,W,12,13,2,12,5,17,55,27,44,19,10,13,6,19,50,30,34,17,11,67M 33S,13,17,67M 33S,12,15,NA,NA,NA,NA
2021-04-24,Siena,St. Bonaventure,Away,L,6,11,NA,6,3,9,36,21,23,17,5,11,3,14,33,22,27,17,11,60M 0S,11,11,60M 0S,6,15,NA,NA,NA,NA
2021-04-30,Siena,Monmouth,Away,W,11,12,NA,11,6,17,32,23,22,15,8,12,5,17,46,34,39,14,10,60M 0S,12,22,60M 0S,11,12,NA,NA,NA,NA
2021-03-06,St. Bonaventure,Quinnipiac,Away,W,13,6,NA,13,11,24,31,24,22,13,5,6,6,12,38,20,26,13,5,60M 0S,6,14,60M 0S,13,11,NA,NA,NA,NA
2021-03-13,St. Bonaventure,Detroit Mercy,Away,L,7,11,NA,7,5,12,38,21,18,18,7,11,6,17,48,25,38,17,12,60M 0S,11,14,60M 0S,7,14,NA,NA,NA,NA
2021-03-20,St. Bonaventure,Monmouth,Away,W,12,13,NA,12,6,18,26,19,16,15,5,13,7,20,42,25,44,15,7,60M 0S,13,12,60M 0S,12,7,NA,NA,NA,NA
2021-03-27,St. Bonaventure,Quinnipiac,Home,L,4,5,NA,4,2,6,36,18,21,15,10,5,3,8,29,16,23,21,8,60M 0S,5,11,60M 0S,4,14,NA,NA,NA,NA
2021-04-02,St. Bonaventure,Manhattan,Home,W,9,8,NA,9,8,17,29,19,32,19,6,8,4,12,36,22,24,10,7,60M 0S,8,15,60M 0S,9,10,NA,NA,NA,NA
2021-04-06,St. Bonaventure,Canisius,Away,L,9,11,NA,9,4,13,32,18,26,20,8,11,8,19,43,26,37,19,7,59M 43S,11,15,59M 43S,9,9,NA,NA,NA,NA
2021-04-11,St. Bonaventure,Canisius,Home,W,12,11,NA,12,8,20,39,23,30,15,7,11,3,14,45,26,25,11,9,60M 0S,11,15,60M 0S,12,11,NA,NA,NA,NA
2021-04-24,St. Bonaventure,Siena,Home,L,11,6,NA,11,3,14,33,22,27,17,11,6,3,9,36,21,23,17,5,60M 0S,6,15,60M 0S,11,11,NA,NA,NA,NA
2021-04-30,St. Bonaventure,Detroit Mercy,Home,L,11,8,NA,11,6,17,30,21,29,20,7,8,4,12,40,20,27,18,7,60M 0S,8,12,60M 0S,11,10,NA,NA,NA,NA
2021-05-05,St. Bonaventure,Monmouth,Away,L,5,12,NA,5,4,9,24,14,23,15,10,12,8,20,39,25,35,16,11,60M 0S,12,13,60M 0S,5,9,NA,NA,NA,NA
2021-02-13,St. John's (NY),Hofstra,Away,L,19,18,1,19,10,29,53,31,38,12,12,18,10,28,35,24,43,29,6,61M 29S,18,6,61M 29S,19,12,NA,NA,NA,NA
2021-02-21,St. John's (NY),Providence,Home,W,8,16,NA,8,1,9,26,15,21,19,10,16,8,24,59,33,44,19,4,60M 0S,16,17,60M 0S,8,7,NA,NA,NA,NA
2021-02-27,St. John's (NY),Georgetown,Away,W,1,19,NA,1,0,1,25,15,29,23,10,19,16,35,47,33,40,26,13,60M 0S,19,14,60M 0S,1,14,NA,NA,NA,NA
2021-03-06,St. John's (NY),Denver,Home,W,6,20,NA,6,3,9,27,21,26,17,7,20,13,33,64,39,42,18,10,60M 0S,20,19,60M 0S,6,15,NA,NA,NA,NA
2021-03-14,St. John's (NY),Villanova,Away,L,8,20,NA,8,5,13,37,21,26,16,8,20,13,33,53,28,33,14,4,60M 0S,20,8,60M 0S,8,13,NA,NA,NA,NA
2021-04-03,St. John's (NY),Georgetown,Home,W,7,20,NA,7,6,13,26,14,21,22,4,20,20,40,63,38,50,12,8,60M 0S,20,18,60M 0S,7,7,NA,NA,NA,NA
2021-04-10,St. John's (NY),Providence,Away,L,9,19,NA,9,6,15,36,24,17,9,1,19,14,33,64,38,37,9,2,60M 0S,19,19,60M 0S,9,15,NA,NA,NA,NA
2021-04-14,St. John's (NY),Marquette,Away,W,8,9,1,8,6,14,34,20,24,20,5,9,6,15,54,28,36,17,9,61M 34S,9,19,61M 34S,8,12,NA,NA,NA,NA
2021-04-17,St. John's (NY),Villanova,Home,W,8,23,NA,8,5,13,28,15,34,19,10,23,15,38,59,40,38,14,15,60M 0S,23,17,60M 0S,8,7,NA,NA,NA,NA
2021-04-24,St. John's (NY),Denver,Away,W,11,19,NA,11,9,20,33,15,13,13,4,19,11,30,57,35,44,14,7,60M 0S,19,16,60M 0S,11,4,NA,NA,NA,NA
2021-04-30,St. John's (NY),Marquette,Home,L,14,15,NA,14,9,23,49,31,32,18,6,15,6,21,42,28,32,12,8,60M 0S,15,13,60M 0S,14,17,NA,NA,NA,NA
2021-02-13,Stony Brook,Sacred Heart,Home,L,20,8,NA,20,14,34,55,40,41,13,4,8,5,13,33,19,23,17,6,60M 0S,8,11,60M 0S,20,20,NA,NA,NA,NA
2021-02-20,Stony Brook,Bryant,Home,L,14,8,NA,14,9,23,40,24,34,13,7,8,4,12,41,24,32,17,6,60M 0S,8,16,60M 0S,14,10,NA,NA,NA,NA
2021-02-27,Stony Brook,Hofstra,Away,W,17,20,NA,17,9,26,52,33,32,11,6,20,9,29,41,28,33,17,4,60M 0S,20,8,60M 0S,17,16,NA,NA,NA,NA
2021-03-06,Stony Brook,UMBC,Away,W,12,13,4,12,7,19,45,28,33,17,5,13,6,19,47,28,33,25,7,74M 51S,13,15,74M 51S,12,16,NA,NA,NA,NA
2021-03-12,Stony Brook,Syracuse,Away,L,9,17,NA,9,4,13,46,23,33,10,7,17,10,27,45,31,42,15,7,60M 0S,17,14,60M 0S,9,14,NA,NA,NA,NA
2021-03-14,Stony Brook,NJIT,Home,L,13,4,NA,13,10,23,53,32,38,13,9,4,3,7,22,11,20,24,5,60M 0S,4,7,60M 0S,13,19,NA,NA,NA,NA
2021-03-20,Stony Brook,UMass Lowell,Away,W,16,9,NA,16,12,28,58,35,29,13,8,9,7,16,24,18,29,18,9,60M 0S,9,9,60M 0S,16,19,NA,NA,NA,NA
2021-03-27,Stony Brook,UAlbany,Home,W,16,10,NA,16,13,29,49,23,38,17,7,10,10,20,33,22,27,14,7,60M 0S,10,12,60M 0S,16,7,NA,NA,NA,NA
2021-04-03,Stony Brook,Hartford,Away,W,17,6,NA,17,9,26,56,27,44,16,3,6,3,9,30,20,21,15,8,60M 0S,6,14,60M 0S,17,10,NA,NA,NA,NA
2021-04-10,Stony Brook,NJIT,Away,W,12,8,NA,12,8,20,45,30,28,14,12,8,5,13,24,15,31,25,4,60M 0S,8,7,60M 0S,12,18,NA,NA,NA,NA
2021-04-16,Stony Brook,Binghamton,Home,L,22,8,NA,22,15,37,46,33,46,15,6,8,4,12,27,19,34,19,6,60M 0S,8,11,60M 0S,22,11,NA,NA,NA,NA
2021-04-24,Stony Brook,UMBC,Home,L,13,14,1,13,5,18,49,29,38,8,4,14,11,25,40,25,25,8,7,63M 32S,14,11,63M 32S,13,16,NA,NA,NA,NA
2021-05-01,Stony Brook,Vermont,Away,W,13,14,NA,13,9,22,35,20,25,10,12,14,10,24,42,29,36,15,7,60M 0S,14,15,60M 0S,13,7,NA,NA,NA,NA
2021-05-06,Stony Brook,"Vermont Baltimore, Md.",Away,L,7,10,NA,7,5,12,36,22,22,10,8,10,5,15,38,26,28,21,7,60M 0S,10,16,60M 0S,7,15,NA,NA,NA,NA
2021-02-21,Syracuse,Army West Point,Home,L,11,18,NA,11,5,16,36,24,33,12,5,18,11,29,44,31,26,10,6,60M 0S,18,13,60M 0S,11,13,NA,NA,NA,NA
2021-02-27,Syracuse,Virginia,Home,W,20,10,NA,20,11,31,55,39,35,12,10,10,5,15,40,25,36,12,8,60M 0S,10,15,60M 0S,20,19,NA,NA,NA,NA
2021-03-06,Syracuse,Vermont,Home,W,17,13,NA,17,10,27,32,29,29,10,9,13,5,18,52,34,45,15,4,60M 0S,13,21,60M 0S,17,12,NA,NA,NA,NA
2021-03-12,Syracuse,Stony Brook,Home,L,17,9,NA,17,10,27,45,31,42,15,7,9,4,13,46,23,33,10,7,60M 0S,9,14,60M 0S,17,14,NA,NA,NA,NA
2021-03-20,Syracuse,Holy Cross,Home,L,15,6,NA,15,9,24,65,34,38,11,14,6,2,8,20,11,28,24,8,60M 0S,6,5,60M 0S,15,19,NA,NA,NA,NA
2021-03-25,Syracuse,Duke,Away,W,14,15,NA,14,9,23,36,24,15,16,5,15,8,23,41,28,31,16,6,60M 0S,15,13,60M 0S,14,10,NA,NA,NA,NA
2021-04-03,Syracuse,Notre Dame,Home,L,11,18,NA,11,3,14,34,21,20,12,8,18,10,28,47,29,45,16,5,60M 0S,18,11,60M 0S,11,10,NA,NA,NA,NA
2021-04-08,Syracuse,UAlbany,Home,L,13,8,NA,13,6,19,50,27,42,14,11,8,7,15,30,20,25,15,4,60M 0S,8,12,60M 0S,13,14,NA,NA,NA,NA
2021-04-17,Syracuse,North Carolina,Home,W,9,21,NA,9,6,15,38,22,33,14,7,21,13,34,58,37,42,12,7,60M 0S,21,16,60M 0S,9,13,NA,NA,NA,NA
2021-04-24,Syracuse,Virginia,Away,L,13,11,NA,13,9,22,54,29,38,18,5,11,8,19,30,20,28,10,9,60M 0S,11,9,60M 0S,13,16,NA,NA,NA,NA
2021-05-01,Syracuse,Notre Dame,Away,L,8,22,NA,8,5,13,43,22,30,16,9,22,13,35,63,31,42,15,10,60M 0S,22,9,60M 0S,8,14,NA,NA,NA,NA
2021-05-07,Syracuse,Robert Morris,Home,W,21,14,NA,21,12,33,58,41,45,16,6,14,7,21,39,24,30,13,14,60M 0S,14,10,60M 0S,21,20,NA,NA,NA,NA
2021-05-15,Syracuse,"Georgetown College Park, Md.",Away,L,8,18,NA,8,4,12,33,18,23,13,3,18,7,25,43,33,33,8,9,60M 0S,18,15,60M 0S,8,10,NA,NA,NA,NA
2021-02-06,Towson,Virginia,Away,W,11,20,NA,11,5,16,31,21,35,21,5,20,11,31,50,32,56,20,14,60M 0S,20,12,60M 0S,11,10,NA,NA,NA,NA
2021-02-13,Towson,Saint Joseph's,Home,W,8,7,1,8,4,12,42,20,40,21,17,7,2,9,34,18,33,28,5,61M 24S,7,11,61M 24S,8,12,NA,NA,NA,NA
2021-02-20,Towson,Duke,Home,W,7,19,NA,7,5,12,28,16,26,16,6,19,9,28,50,32,41,16,4,60M 0S,19,13,60M 0S,7,9,NA,NA,NA,NA
2021-02-24,Towson,Mount St. Mary's,Away,W,11,5,NA,11,6,17,23,14,13,26,7,5,0,5,33,23,33,19,13,60M 0S,5,18,60M 0S,11,3,NA,NA,NA,NA
2021-02-27,Towson,Richmond,Away,W,10,11,NA,10,8,18,35,23,25,14,8,11,5,16,35,16,29,20,5,60M 0S,11,5,60M 0S,10,13,NA,NA,NA,NA
2021-03-06,Towson,Drexel,Away,W,10,12,NA,10,4,14,36,22,27,19,7,12,8,20,43,24,21,16,11,60M 0S,12,12,60M 0S,10,12,NA,NA,NA,NA
2021-03-20,Towson,Delaware,Away,W,12,13,1,12,8,20,37,23,37,14,15,13,5,18,41,25,28,19,8,61M 19S,13,12,61M 19S,12,11,NA,NA,NA,NA
2021-03-27,Towson,Loyola Maryland,Home,W,7,6,1,7,1,8,38,15,28,13,2,6,2,8,34,14,27,16,6,62M 41S,6,8,62M 41S,7,8,NA,NA,NA,NA
2021-04-03,Towson,Hofstra,Away,W,7,8,NA,7,6,13,31,19,19,17,5,8,5,13,31,18,26,22,3,60M 0S,8,10,60M 0S,7,12,NA,NA,NA,NA
2021-04-10,Towson,Fairfield,Home,W,12,11,NA,12,8,20,49,22,30,15,10,11,6,17,41,21,37,15,7,60M 0S,11,10,60M 0S,12,10,NA,NA,NA,NA
2021-04-13,Towson,Hofstra,Home,L,10,8,NA,10,5,15,36,17,21,13,9,8,3,11,36,22,35,12,9,60M 0S,8,14,60M 0S,10,7,NA,NA,NA,NA
2021-04-17,Towson,Massachusetts,Away,L,9,6,NA,9,5,14,34,19,25,20,6,6,3,9,31,19,35,21,12,60M 0S,6,13,60M 0S,9,10,NA,NA,NA,NA
2021-04-24,Towson,Delaware,Home,W,8,16,NA,8,3,11,35,21,24,14,7,16,10,26,32,23,38,10,7,60M 0S,16,7,60M 0S,8,13,NA,NA,NA,NA
2021-05-01,Towson,Drexel,Home,L,11,12,NA,11,8,19,42,22,29,14,4,12,4,16,51,26,31,11,4,60M 0S,12,14,60M 0S,11,11,NA,NA,NA,NA
2021-02-27,UAlbany,Colgate,Home,L,15,9,NA,15,12,27,32,22,37,18,8,9,5,14,27,19,23,20,5,60M 0S,9,10,60M 0S,15,7,NA,NA,NA,NA
2021-03-06,UAlbany,Hartford,Away,W,16,6,NA,16,11,27,43,29,32,17,7,6,2,8,34,16,33,21,9,60M 0S,6,10,60M 0S,16,13,NA,NA,NA,NA
2021-03-13,UAlbany,Vermont,Home,L,12,14,NA,12,4,16,38,26,37,15,8,14,9,23,45,28,41,18,9,60M 0S,14,14,60M 0S,12,14,NA,NA,NA,NA
2021-03-20,UAlbany,Binghamton,Away,W,19,7,NA,19,13,32,46,38,43,18,9,7,3,10,31,23,29,20,11,60M 0S,7,16,60M 0S,19,19,NA,NA,NA,NA
2021-03-23,UAlbany,Massachusetts,Home,W,13,12,NA,13,10,23,41,23,42,18,4,12,8,20,45,28,37,11,5,60M 0S,12,16,60M 0S,13,10,NA,NA,NA,NA
2021-03-27,UAlbany,Stony Brook,Away,W,10,16,NA,10,10,20,33,22,27,14,7,16,13,29,49,23,38,17,7,60M 0S,16,7,60M 0S,10,12,NA,NA,NA,NA
2021-04-03,UAlbany,UMass Lowell,Home,L,17,6,NA,17,13,30,43,31,55,20,11,6,3,9,36,15,50,24,8,60M 0S,6,9,60M 0S,17,14,NA,NA,NA,NA
2021-04-08,UAlbany,Syracuse,Away,L,8,13,NA,8,7,15,30,20,25,15,4,13,6,19,50,27,42,14,11,60M 0S,13,14,60M 0S,8,12,NA,NA,NA,NA
2021-04-11,UAlbany,UMBC,Home,L,14,9,NA,14,13,27,42,20,37,24,9,9,1,10,32,17,33,22,9,60M 0S,9,8,60M 0S,14,6,NA,NA,NA,NA
2021-04-24,UAlbany,NJIT,Home,L,18,8,NA,18,14,32,47,32,43,16,8,8,3,11,34,16,36,22,6,60M 0S,8,8,60M 0S,18,14,NA,NA,NA,NA
2021-04-28,UAlbany,Vermont,Away,W,14,16,NA,14,9,23,37,29,37,15,18,16,7,23,42,26,41,25,8,60M 0S,16,10,60M 0S,14,15,NA,NA,NA,NA
2021-05-06,UAlbany,"UMBC Baltimore, Md.",Away,L,14,12,NA,14,7,21,37,22,29,17,2,12,8,20,37,19,32,18,5,60M 0S,12,7,60M 0S,14,8,NA,NA,NA,NA
2021-05-08,UAlbany,"Vermont Baltimore, Md.",Away,W,10,15,NA,10,10,20,31,18,20,11,0,15,11,26,50,31,37,11,6,60M 0S,15,16,60M 0S,10,8,NA,NA,NA,NA
2021-02-27,UMBC,Mount St. Mary's,Home,W,8,7,1,8,4,12,31,18,18,17,7,7,2,9,27,15,19,22,2,64M 0S,7,8,64M 0S,8,10,NA,NA,NA,NA
2021-03-06,UMBC,Stony Brook,Home,W,13,12,4,13,6,19,47,28,33,25,7,12,7,19,45,28,33,17,5,74M 51S,12,16,74M 51S,13,15,NA,NA,NA,NA
2021-03-20,UMBC,Hartford,Away,L,13,10,NA,13,6,19,30,22,25,14,8,10,4,14,37,20,27,14,6,60M 0S,10,10,60M 0S,13,9,NA,NA,NA,NA
2021-03-24,UMBC,Binghamton,Away,W,7,8,1,7,5,12,48,25,31,18,8,8,5,13,25,13,25,20,9,63M 59S,8,5,63M 59S,7,18,NA,NA,NA,NA
2021-03-27,UMBC,Binghamton,Home,W,7,6,NA,7,5,12,45,24,28,14,4,6,2,8,21,14,26,19,5,60M 0S,6,8,60M 0S,7,17,NA,NA,NA,NA
2021-04-03,UMBC,Vermont,Home,L,10,8,NA,10,7,17,40,21,22,19,7,8,6,14,32,19,27,20,1,60M 0S,8,11,60M 0S,10,11,NA,NA,NA,NA
2021-04-11,UMBC,UAlbany,Away,L,9,14,NA,9,1,10,32,17,33,22,9,14,13,27,42,20,37,24,9,60M 0S,14,6,60M 0S,9,8,NA,NA,NA,NA
2021-04-17,UMBC,UMass Lowell,Home,L,12,7,NA,12,11,23,40,25,27,17,8,7,3,10,28,19,22,17,7,60M 0S,7,12,60M 0S,12,13,NA,NA,NA,NA
2021-04-24,UMBC,Stony Brook,Away,L,14,13,1,14,11,25,40,25,25,8,7,13,5,18,49,29,38,8,4,63M 32S,13,16,63M 32S,14,11,NA,NA,NA,NA
2021-05-01,UMBC,NJIT,Away,W,14,6,NA,14,3,17,44,26,34,12,3,6,4,10,42,24,26,13,9,60M 0S,6,18,60M 0S,14,12,NA,NA,NA,NA
2021-05-06,UMBC,"UAlbany Baltimore, Md.",Away,W,12,14,NA,12,8,20,37,19,32,18,5,14,7,21,37,22,29,17,2,60M 0S,14,8,60M 0S,12,7,NA,NA,NA,NA
2021-02-27,UMass Lowell,Merrimack,Home,W,8,16,NA,8,3,11,37,19,33,26,11,16,10,26,45,30,40,22,12,60M 0S,16,14,60M 0S,8,11,NA,NA,NA,NA
2021-03-03,UMass Lowell,Vermont,Away,L,7,21,NA,7,4,11,34,20,33,12,9,21,13,34,56,37,39,14,9,59M 45S,21,16,59M 45S,7,13,NA,NA,NA,NA
2021-03-13,UMass Lowell,Hartford,Home,W,12,10,NA,12,4,16,40,19,31,17,8,10,2,12,33,23,35,16,11,60M 0S,10,13,60M 0S,12,7,NA,NA,NA,NA
2021-03-20,UMass Lowell,Stony Brook,Home,W,9,16,NA,9,7,16,24,18,29,18,9,16,12,28,58,35,29,13,8,60M 0S,16,19,60M 0S,9,9,NA,NA,NA,NA
2021-03-27,UMass Lowell,NJIT,Home,L,10,14,NA,10,6,16,47,21,33,13,5,14,7,21,34,22,29,18,5,60M 0S,14,8,60M 0S,10,11,NA,NA,NA,NA
2021-04-03,UMass Lowell,UAlbany,Away,L,6,17,NA,6,3,9,36,15,50,24,8,17,13,30,43,31,55,20,11,60M 0S,17,14,60M 0S,6,9,NA,NA,NA,NA
2021-04-10,UMass Lowell,Vermont,Home,W,5,16,NA,5,5,10,26,14,16,15,3,16,8,24,55,29,30,10,7,60M 0S,16,13,60M 0S,5,9,NA,NA,NA,NA
2021-04-17,UMass Lowell,UMBC,Away,L,7,12,NA,7,3,10,28,19,22,17,7,12,11,23,40,25,27,17,8,60M 0S,12,13,60M 0S,7,12,NA,NA,NA,NA
2021-05-02,UMass Lowell,Binghamton,Home,W,9,11,NA,9,7,16,33,18,27,20,4,11,7,18,36,25,37,24,13,60M 0S,11,14,60M 0S,9,9,NA,NA,NA,NA
2021-01-30,Utah,Denver,Away,W,8,9,NA,8,4,12,36,19,22,16,5,9,6,15,49,25,27,13,8,60M 0S,9,16,60M 0S,8,11,NA,NA,NA,NA
2021-02-06,Utah,Bellarmine,Away,W,12,7,NA,12,7,19,31,22,27,16,6,7,6,13,31,16,21,12,10,60M 0S,7,9,60M 0S,12,10,NA,NA,NA,NA
2021-02-20,Utah,Air Force,Away,L,9,10,1,9,7,16,37,20,28,15,5,10,7,17,43,24,28,14,8,62M 25S,10,14,62M 25S,9,11,NA,NA,NA,NA
2021-02-27,Utah,Loyola Maryland,Away,L,8,20,NA,8,4,12,30,15,23,15,3,20,11,31,49,27,31,13,10,60M 0S,20,7,60M 0S,8,7,NA,NA,NA,NA
2021-03-06,Utah,Jacksonville,Home,L,3,8,NA,3,2,5,16,6,18,21,5,8,2,10,40,20,33,11,7,60M 0S,8,12,60M 0S,3,3,NA,NA,NA,NA
2021-03-13,Utah,Westminster (UT),Home,L,18,5,NA,18,11,29,55,31,55,23,5,5,2,7,20,11,25,24,7,59M 53S,5,6,59M 53S,18,13,NA,NA,NA,NA
2021-03-27,Utah,Mercer,Away,W,10,15,NA,10,6,16,47,27,24,12,4,15,10,25,47,25,45,16,8,60M 0S,15,10,60M 0S,10,17,NA,NA,NA,NA
2021-04-03,Utah,Boston U.,Away,L,11,10,2,11,5,16,39,20,32,21,10,10,5,15,53,23,38,21,9,64M 28S,10,13,64M 28S,11,9,NA,NA,NA,NA
2021-04-17,Utah,Virginia,Away,W,11,18,NA,11,2,13,35,24,32,20,7,18,8,26,48,31,59,21,10,60M 0S,18,13,60M 0S,11,13,NA,NA,NA,NA
2021-04-24,Utah,Cleveland St.,Away,W,11,9,NA,11,5,16,32,18,25,24,5,9,6,15,42,24,37,15,15,59M 15S,9,15,59M 15S,11,7,NA,NA,NA,NA
2021-05-01,Utah,Robert Morris,Home,L,12,16,NA,12,7,19,42,24,24,8,6,16,8,24,42,29,32,12,5,60M 0S,16,13,60M 0S,12,12,NA,NA,NA,NA
2021-03-06,VMI,Lafayette,Away,L,13,12,NA,13,9,22,44,27,43,15,14,12,9,21,30,18,37,19,8,60M 0S,12,6,60M 0S,13,14,NA,NA,NA,NA
2021-03-09,VMI,Bellarmine,Away,L,8,12,NA,8,4,12,31,21,27,22,11,12,6,18,36,27,37,21,11,60M 0S,12,15,60M 0S,8,13,NA,NA,NA,NA
2021-03-13,VMI,Richmond,Home,W,6,23,NA,6,3,9,19,13,18,22,12,23,16,39,57,42,46,17,9,60M 0S,23,19,60M 0S,6,7,NA,NA,NA,NA
2021-03-19,VMI,High Point,Home,L,12,20,NA,12,4,16,31,20,28,20,11,20,13,33,38,29,36,19,6,60M 0S,20,9,60M 0S,12,8,NA,NA,NA,NA
2021-03-27,VMI,Jacksonville,Away,W,12,18,NA,12,7,19,42,24,33,18,13,18,11,29,44,32,50,24,11,60M 0S,18,14,60M 0S,12,12,NA,NA,NA,NA
2021-04-03,VMI,Cleveland St.,Away,L,4,16,NA,4,0,4,33,15,15,17,8,16,13,29,52,26,39,17,6,60M 0S,16,10,60M 0S,4,11,NA,NA,NA,NA
2021-04-07,VMI,Mount St. Mary's,Home,W,9,16,NA,9,7,16,42,23,24,11,7,16,9,25,42,25,38,17,7,60M 0S,16,9,60M 0S,9,14,NA,NA,NA,NA
2021-04-10,VMI,Bellarmine,Home,W,9,11,NA,9,6,15,32,23,26,16,11,11,7,18,36,20,27,18,11,60M 0S,11,9,60M 0S,9,14,NA,NA,NA,NA
2021-04-17,VMI,Air Force,Away,L,4,18,NA,4,3,7,22,11,19,24,5,18,10,28,52,31,39,13,13,60M 0S,18,13,60M 0S,4,7,NA,NA,NA,NA
2021-04-24,VMI,Mercer,Away,L,9,17,NA,9,6,15,40,20,27,12,5,17,9,26,43,28,42,21,5,60M 0S,17,11,60M 0S,9,11,NA,NA,NA,NA
2021-05-01,VMI,Cleveland St.,Home,L,11,14,NA,11,7,18,41,18,29,16,17,14,3,17,31,21,35,27,7,60M 0S,14,7,60M 0S,11,7,NA,NA,NA,NA
2021-02-27,Vermont,Bryant,Away,W,12,15,NA,12,6,18,36,21,39,20,8,15,8,23,42,28,46,19,11,60M 0S,15,13,60M 0S,12,9,NA,NA,NA,NA
2021-03-03,Vermont,UMass Lowell,Home,L,21,7,NA,21,13,34,56,37,39,14,9,7,4,11,34,20,33,12,9,59M 45S,7,13,59M 45S,21,16,NA,NA,NA,NA
2021-03-06,Vermont,Syracuse,Away,W,13,17,NA,13,5,18,52,34,45,15,4,17,10,27,32,29,29,10,9,60M 0S,17,12,60M 0S,13,21,NA,NA,NA,NA
2021-03-13,Vermont,UAlbany,Away,L,14,12,NA,14,9,23,45,28,41,18,9,12,4,16,38,26,37,15,8,60M 0S,12,14,60M 0S,14,14,NA,NA,NA,NA
2021-03-20,Vermont,NJIT,Away,W,17,2,NA,17,14,31,76,39,34,15,4,2,1,3,25,15,17,13,7,60M 0S,2,13,60M 0S,17,22,NA,NA,NA,NA
2021-03-27,Vermont,Hartford,Home,L,14,9,NA,14,5,19,50,32,37,17,10,9,6,15,35,18,28,15,11,60M 0S,9,9,60M 0S,14,18,NA,NA,NA,NA
2021-04-03,Vermont,UMBC,Away,L,8,10,NA,8,6,14,32,19,27,20,1,10,7,17,40,21,22,19,7,60M 0S,10,11,60M 0S,8,11,NA,NA,NA,NA
2021-04-10,Vermont,UMass Lowell,Away,W,16,5,NA,16,8,24,55,29,30,10,7,5,5,10,26,14,16,15,3,60M 0S,5,9,60M 0S,16,13,NA,NA,NA,NA
2021-04-24,Vermont,Binghamton,Away,L,7,10,NA,7,2,9,41,22,30,16,5,10,4,14,38,21,28,15,12,60M 0S,10,11,60M 0S,7,15,NA,NA,NA,NA
2021-04-28,Vermont,UAlbany,Home,W,16,14,NA,16,7,23,42,26,41,25,8,14,9,23,37,29,37,15,18,60M 0S,14,15,60M 0S,16,10,NA,NA,NA,NA
2021-05-01,Vermont,Stony Brook,Home,W,14,13,NA,14,10,24,42,29,36,15,7,13,9,22,35,20,25,10,12,60M 0S,13,7,60M 0S,14,15,NA,NA,NA,NA
2021-05-06,Vermont,"Stony Brook Baltimore, Md.",Away,W,10,7,NA,10,5,15,38,26,28,21,7,7,5,12,36,22,22,10,8,60M 0S,7,15,60M 0S,10,16,NA,NA,NA,NA
2021-05-08,Vermont,"UAlbany Baltimore, Md.",Away,L,15,10,NA,15,11,26,50,31,37,11,6,10,10,20,31,18,20,11,0,60M 0S,10,8,60M 0S,15,16,NA,NA,NA,NA
2021-05-16,Vermont,Maryland,Away,W,11,17,NA,11,7,18,30,18,31,22,6,17,6,23,40,29,44,13,12,60M 0S,17,12,60M 0S,11,7,NA,NA,NA,NA
2021-02-21,Villanova,Georgetown,Home,L,1,16,NA,1,0,1,27,7,12,19,4,16,12,28,43,26,27,14,11,60M 0S,16,10,60M 0S,1,6,NA,NA,NA,NA
2021-02-27,Villanova,Marquette,Away,L,16,14,NA,16,7,23,51,31,22,10,3,14,9,23,39,21,28,11,5,60M 0S,14,7,60M 0S,16,15,NA,NA,NA,NA
2021-03-07,Villanova,Providence,Away,W,11,8,NA,11,7,18,37,19,17,21,10,8,5,13,43,24,23,19,14,60M 0S,8,16,60M 0S,11,8,NA,NA,NA,NA
2021-03-14,Villanova,St. John's (NY),Home,L,20,8,NA,20,13,33,53,28,33,14,4,8,5,13,37,21,26,16,8,60M 0S,8,13,60M 0S,20,8,NA,NA,NA,NA
2021-03-27,Villanova,Georgetown,Away,W,7,8,NA,7,4,11,35,18,28,16,4,8,4,12,51,23,30,9,10,60M 0S,8,15,60M 0S,7,11,NA,NA,NA,NA
2021-04-03,Villanova,Providence,Home,L,13,6,NA,13,4,17,45,24,24,9,7,6,2,8,33,17,28,21,4,60M 0S,6,11,60M 0S,13,11,NA,NA,NA,NA
2021-04-10,Villanova,Denver,Away,W,10,17,NA,10,5,15,38,22,27,16,9,17,9,26,36,25,36,16,11,60M 0S,17,8,60M 0S,10,12,NA,NA,NA,NA
2021-04-17,Villanova,St. John's (NY),Away,W,23,8,NA,23,15,38,59,40,38,14,15,8,5,13,28,15,34,19,10,60M 0S,8,7,60M 0S,23,17,NA,NA,NA,NA
2021-04-24,Villanova,Marquette,Home,L,19,8,NA,19,13,32,41,27,27,12,11,8,4,12,37,18,27,17,4,60M 0S,8,10,60M 0S,19,8,NA,NA,NA,NA
2021-04-28,Villanova,Denver,Home,L,10,11,1,10,4,14,50,30,21,8,11,11,6,17,36,21,29,17,5,61M 3S,11,10,61M 3S,10,20,NA,NA,NA,NA
2021-05-01,Villanova,Lehigh,Home,L,16,8,NA,16,10,26,43,30,24,14,15,8,2,10,41,18,30,24,5,60M 0S,8,10,60M 0S,16,14,NA,NA,NA,NA
2021-05-06,Villanova,"Georgetown Providence, R.I.",Away,W,12,14,NA,12,4,16,44,29,25,10,9,14,11,25,39,21,32,20,6,60M 0S,14,7,60M 0S,12,17,NA,NA,NA,NA
2021-02-06,Virginia,Towson,Home,W,20,11,NA,20,11,31,50,32,56,20,14,11,5,16,31,21,35,21,5,60M 0S,11,10,60M 0S,20,12,NA,NA,NA,NA
2021-02-14,Virginia,Army West Point,Home,L,14,9,NA,14,7,21,46,25,47,14,13,9,3,12,38,22,27,16,6,60M 0S,9,13,60M 0S,14,11,NA,NA,NA,NA
2021-02-20,Virginia,Loyola Maryland,Away,L,15,12,NA,15,3,18,50,25,26,11,4,12,5,17,46,21,36,14,7,60M 0S,12,9,60M 0S,15,10,NA,NA,NA,NA
2021-02-27,Virginia,Syracuse,Away,W,10,20,NA,10,5,15,40,25,36,12,8,20,11,31,55,39,35,12,10,60M 0S,20,19,60M 0S,10,15,NA,NA,NA,NA
2021-03-03,Virginia,High Point,Home,W,12,11,NA,12,8,20,43,27,59,26,10,11,4,15,38,28,39,25,12,60M 0S,11,17,60M 0S,12,15,NA,NA,NA,NA
2021-03-06,Virginia,Air Force,Home,L,20,4,NA,20,17,37,43,27,56,29,17,4,3,7,28,15,31,26,7,60M 0S,4,11,60M 0S,20,7,NA,NA,NA,NA
2021-03-11,Virginia,North Carolina,Home,L,13,16,NA,13,8,21,62,33,37,11,3,16,12,28,48,31,24,8,4,60M 0S,16,15,60M 0S,13,20,NA,NA,NA,NA
2021-03-20,Virginia,Robert Morris,Home,W,14,12,NA,14,11,25,35,23,43,26,5,12,9,21,52,27,31,18,8,60M 0S,12,15,60M 0S,14,9,NA,NA,NA,NA
2021-03-27,Virginia,Notre Dame,Away,L,12,11,NA,12,9,21,30,19,21,14,2,11,7,18,42,20,30,10,8,60M 0S,11,9,60M 0S,12,7,NA,NA,NA,NA
2021-04-03,Virginia,Richmond,Home,W,18,10,NA,18,12,30,47,28,54,21,16,10,8,18,30,20,36,22,13,60M 0S,10,10,60M 0S,18,10,NA,NA,NA,NA
2021-04-10,Virginia,North Carolina,Away,L,18,16,NA,18,13,31,44,33,36,15,3,16,6,22,51,31,37,10,8,60M 0S,16,15,60M 0S,18,15,NA,NA,NA,NA
2021-04-15,Virginia,Duke,Home,L,12,13,1,12,5,17,49,28,42,10,10,13,6,19,50,29,25,14,4,63M 28S,13,16,63M 28S,12,16,NA,NA,NA,NA
2021-04-17,Virginia,Utah,Home,W,18,11,NA,18,8,26,48,31,59,21,10,11,2,13,35,24,32,20,7,60M 0S,11,13,60M 0S,18,13,NA,NA,NA,NA
2021-04-24,Virginia,Syracuse,Home,L,11,13,NA,11,8,19,30,20,28,10,9,13,9,22,54,29,38,18,5,60M 0S,13,16,60M 0S,11,9,NA,NA,NA,NA
2021-05-16,Virginia,Bryant,Home,W,13,11,NA,13,9,22,38,21,44,11,8,11,6,17,47,29,31,12,5,60M 0S,11,18,60M 0S,13,8,NA,NA,NA,NA
2021-05-22,Virginia,"Georgetown Hempstead, N.Y.",Away,W,14,3,NA,14,4,18,45,22,31,15,12,3,2,5,27,13,16,18,3,60M 0S,3,10,60M 0S,14,8,NA,NA,NA,NA
2021-05-29,Virginia,"North Carolina East Hartford, Conn.",Away,L,12,11,NA,12,5,17,39,17,43,22,7,11,4,15,49,26,38,12,15,60M 0S,11,15,60M 0S,12,5,NA,NA,NA,NA
2021-05-31,Virginia,"Maryland East Hartford, Conn.",Away,L,17,16,NA,17,8,25,39,28,37,14,6,16,12,28,49,28,41,10,10,60M 0S,16,12,60M 0S,17,11,NA,NA,NA,NA
2021-02-27,Wagner,LIU,Away,L,8,19,NA,8,6,14,22,16,24,21,5,19,13,32,42,34,35,18,8,60M 0S,19,15,60M 0S,8,8,NA,NA,NA,NA
2021-03-02,Wagner,Hofstra,Away,L,6,18,NA,6,3,9,22,11,20,28,2,18,10,28,45,31,33,13,11,60M 0S,18,13,60M 0S,6,5,NA,NA,NA,NA
2021-03-08,Wagner,Saint Joseph's,Home,W,5,17,NA,5,3,8,27,13,28,18,2,17,14,31,52,38,50,14,7,60M 0S,17,21,60M 0S,5,8,NA,NA,NA,NA
2021-03-13,Wagner,Merrimack,Away,L,5,11,NA,5,4,9,20,8,23,29,5,11,6,17,51,32,43,13,17,60M 0S,11,21,60M 0S,5,3,NA,NA,NA,NA
2021-03-21,Wagner,Bryant,Home,W,5,18,NA,5,4,9,30,18,30,18,9,18,8,26,49,32,42,15,9,60M 0S,18,14,60M 0S,5,13,NA,NA,NA,NA
2021-03-27,Wagner,LIU,Home,L,13,18,NA,13,11,24,53,26,34,14,6,18,12,30,42,33,38,12,7,60M 0S,18,15,60M 0S,13,13,NA,NA,NA,NA
2021-04-21,Wagner,Sacred Heart,Away,W,11,9,NA,11,4,15,30,18,21,23,5,9,4,13,52,29,31,14,11,60M 0S,9,20,60M 0S,11,7,NA,NA,NA,NA
2021-04-27,Wagner,Hobart,Home,L,8,9,1,8,1,9,28,14,23,19,4,9,6,15,49,21,29,12,5,60M 47S,9,12,60M 47S,8,6,NA,NA,NA,NA
2021-04-30,Wagner,Saint Joseph's,Away,L,7,14,NA,7,5,12,38,20,32,22,5,14,14,28,48,31,37,13,17,60M 0S,14,17,60M 0S,7,13,NA,NA,NA,NA
2021-05-07,Wagner,Mount St. Mary's,Away,L,6,20,NA,6,3,9,34,19,28,22,3,20,14,34,53,38,48,12,13,60M 0S,20,18,60M 0S,6,13,NA,NA,NA,NA
